{
  "largeur": 29,
  "hauteur": 32,
  "chipset": "HunterArene.png",
  "musique": "hunter.ogg",
  "couche0": [
    [ 225,  227,  227,  385,  227,  227,  227,  227,  227,  385,  227,  227,  227,  349,  350,  351,  227,  227,  227,  385,  227,  227,  227,  227,  227,  121,  121,  227,  228],
    [ 255,  257,  257,  415,  257,  257,  257,  257,  257,  415,  257,  257,  257,  379,  380,  381,  257,  257,  257,  415,  257,  257,  257,  257,  257,  151,  151,  257,  258],
    [ 285,  287,  287,  287,  287,  287,  287,  287,  287,  287,  287,  287,  287,  409,  410,  411,  287,  287,  287,  287,  287,  287,  287,  287,  287,  181,  181,  287,  288],
    [ 365,  365,    3,    4,    5,  365,  365,  365,    3,    4,    5,  365,  365,  261,  262,  318,  365,  365,    3,    4,    5,  365,  365,  365,  365,  365,  365,  365,  365],
    [ 365,  365,   33,   34,   35,  365,  365,  365,   33,   34,   35,  365,  365,  291,  292,  348,  365,  365,   33,   34,   35,  365,  365,  365,  365,  365,   62,   62,  365],
    [ 253,  254,  365,  365,  365,  365,  365,  365,  365,  365,  365,  365,  365,  365,  365,  365,  365,  365,  365,  365,  365,  365,  365,  365,  365,  365,   62,  313,  314],
    [ 283,  284,  365,  365,  365,  365,  365,  365,  365,  365,  365,  365,  365,  365,  365,  365,  365,  365,  365,  365,  365,  365,  365,  365,  365,  365,   60,  343,  344],
    [ 365,  365,  365,  365,  365,  365,  365,  365,  365,  365,  365,  365,  365,  365,  365,  365,  365,  365,  365,  365,  365,  365,  365,  365,  365,  365,  365,   62,  365],
    [ 365,  365,  365,  365,  365,  195,  259,  260,  259,  260,  259,  260,  259,  260,  259,  260,  259,  260,  259,  260,  259,  260,  259,  197,  365,  365,  365,  365,  365],
    [ 365,  365,  365,  365,  365,  165,  229,  230,  229,  230,  229,  230,  229,  230,  229,  230,  229,  230,  229,  230,  229,  230,  229,  167,  365,  365,  365,  365,  365],
    [ 365,  365,  365,  365,  365,  195,  259,  260,  259,  260,  259,  260,  259,  260,  259,  260,  259,  260,  259,  260,  259,  260,  259,  197,  365,  365,  365,  365,  335],
    [ 365,  365,  365,  365,  365,  165,  229,  230,  229,  230,  229,  230,  229,  230,  229,  230,  229,  230,  229,  230,  229,  230,  229,  167,  365,   62,   62,  365,  365],
    [ 365,  365,  365,  365,  365,  195,  259,  260,  259,  260,  259,  260,  259,  260,  259,  260,  259,  260,  259,  260,  259,  260,  259,  197,  365,  365,   62,  365,  365],
    [ 365,  365,  365,  365,  365,  165,  229,  230,  229,  230,  229,  230,  229,  230,  229,  230,  229,  230,  229,  230,  229,  230,  229,  167,  365,  365,   62,  365,  365],
    [ 253,  254,  365,  365,  365,  195,  259,  260,  259,  260,  259,  260,  259,  260,  259,  260,  259,  260,  259,  260,  259,  260,  259,  197,  365,  365,   62,  313,  314],
    [ 221,  284,  365,  365,  365,  165,  229,  230,  229,  230,  229,  230,  229,  230,  229,  230,  229,  230,  229,  230,  229,  230,  229,  167,  365,  365,   62,  343,  338],
    [ 251,  252,  365,  365,  365,  195,  259,  260,  259,  260,  259,  260,  259,  260,  259,  260,  259,  260,  259,  260,  259,  260,  259,  197,  365,  365,  365,  367,  368],
    [ 281,  282,  365,  365,  365,  165,  229,  230,  229,  230,  229,  230,  229,  230,  229,  230,  229,  230,  229,  230,  229,  230,  229,  167,  365,  365,  365,  397,  398],
    [ 311,  312,  365,  365,  365,  195,  259,  260,  259,  260,  259,  260,  259,  260,  259,  260,  259,  260,  259,  260,  259,  260,  259,  197,  365,  365,  365,  427,  428],
    [ 341,  254,  365,  365,  365,  165,  229,  230,  229,  230,  229,  230,  229,  230,  229,  230,  229,  230,  229,  230,  229,  230,  229,  167,  365,  365,   62,  313,  458],
    [ 283,  284,  365,  365,  365,  195,  259,  260,  259,  260,  259,  260,  259,  260,  259,  260,  259,  260,  259,  260,  259,  260,  259,  197,  365,  365,   62,  343,  344],
    [ 365,  365,  365,  365,  365,  165,  229,  230,  229,  230,  229,  230,  229,  230,  229,  230,  229,  230,  229,  230,  229,  230,  229,  167,  365,  365,  365,  365,  365],
    [ 365,  365,  365,  365,  365,  195,  259,  260,  259,  260,  259,  260,  259,  260,  259,  260,  259,  260,  259,  260,  259,  260,  259,  197,  365,  365,  365,  365,  365],
    [ 365,  365,  365,  365,  365,  165,  229,  230,  229,  230,  229,  230,  229,  230,  229,  230,  229,  230,  229,  230,  229,  230,  229,  167,  365,  365,  365,  365,  365],
    [ 365,  365,  365,  365,  365,  195,  259,  260,  259,  260,  259,  260,  259,  260,  259,  260,  259,  260,  259,  260,  259,  260,  259,  197,  365,  365,  365,  365,  365],
    [ 365,  365,  365,  365,  365,  165,  229,  230,  229,  230,  229,  230,  229,  230,  229,  230,  229,  230,  229,  230,  229,  230,  229,  167,  365,  365,  365,  365,  365],
    [ 365,  365,  365,  365,  365,  195,  259,  260,  259,  260,  259,  260,  259,  260,  259,  260,  259,  260,  259,  260,  259,  260,  259,  197,  365,  365,  365,  365,  365],
    [ 253,  254,  365,  365,  365,  165,  229,  230,  229,  230,  229,  230,  229,  230,  229,  230,  229,  230,  229,  230,  229,  230,  229,  167,  365,  365,  365,  313,  314],
    [ 283,  284,  365,  365,  365,  365,  365,  365,  365,  365,  365,  365,  365,  365,  365,  365,  365,  365,  365,  365,  365,  365,  365,  365,  365,  365,  365,  343,  344],
    [ 365,  365,  365,  365,  365,  365,  365,  365,  365,  365,  365,  365,  390,  391,  392,  393,  394,  365,  365,  365,  365,  365,  365,  365,  365,  365,  365,  365,  365],
    [ 365,  365,  365,  365,  365,  365,  365,  365,  365,  365,  365,  365,  420,  421,  422,  423,  424,  365,  365,  365,  365,  365,  365,  365,  365,  365,  365,  365,  365],
    [ 365,  365,  365,  365,  365,  365,  365,  365,  365,  365,  365,  365,  450,  451,  452,  453,  454,  365,  365,  365,  365,  365,  365,  365,  365,  365,  365,  365,  365]
  ],
  "couche1": [
    [  -1,  438,  439,   -1,   -1,   -1,   -1,  443,   -1,   -1,   -1,   -1,  446,   -1,   -1,   -1,  446,   -1,   -1,   -1,   -1,  383,   -1,   -1,   -1,  406,  407,   -1,   -1],
    [  -1,  468,  469,   -1,   -1,  417,   -1,  473,   -1,   -1,   -1,   -1,  476,   -1,   -1,   -1,  476,   -1,   -1,   -1,   -1,   -1,  413,   -1,   -1,  436,  437,   -1,  412],
    [  -1,   -1,   -1,   -1,   -1,  447,   -1,  388,   -1,   -1,   -1,  323,   -1,   -1,   -1,   -1,   -1,   -1,   -1,  388,   -1,   -1,   -1,  388,   -1,  466,  467,   -1,  442],
    [ 389,  327,  328,  449,   -1,  477,   -1,  418,   -1,   -1,   -1,  353,   -1,   -1,   -1,   -1,   -1,   -1,   -1,  418,   -1,   -1,   -1,  418,   -1,   -1,   -1,   -1,  472],
    [ 419,  357,  358,  479,   -1,   -1,   -1,   -1,   -1,   -1,   -1,   -1,   -1,   -1,   -1,   -1,   -1,   -1,   -1,   -1,   -1,   -1,   -1,   -1,   -1,   -1,   -1,   -1,   -1],
    [  -1,   -1,   -1,   -1,   -1,   -1,   -1,   -1,   -1,   -1,   -1,   -1,   -1,   -1,   -1,   -1,   -1,   -1,   -1,   -1,   -1,   -1,   -1,   -1,   -1,   -1,   -1,   -1,   -1],
    [  -1,   -1,   -1,   -1,   -1,   -1,   -1,   -1,   -1,   -1,   -1,   -1,   -1,   -1,   -1,   -1,   -1,   -1,   -1,   -1,   -1,   -1,   -1,   -1,   -1,   -1,   -1,   -1,   -1],
    [  -1,   -1,   -1,   -1,   -1,  237,  238,  238,  238,  238,  238,   59,   -1,   -1,   -1,   -1,   -1,   57,  238,  238,  238,  238,  238,  239,   -1,   -1,   -1,   -1,   -1],
    [  -1,   -1,   -1,   -1,   -1,  205,   -1,   -1,   -1,   -1,   -1,   -1,   -1,   -1,   -1,   -1,   -1,   -1,   -1,   -1,   -1,   -1,   -1,  206,   -1,   -1,   -1,   -1,  146],
    [ 326,   -1,   -1,   -1,   -1,  205,   -1,   -1,   -1,   -1,   -1,   -1,   -1,   -1,   -1,   -1,   -1,   -1,   -1,   -1,   -1,   -1,   -1,  206,   -1,   -1,   -1,   -1,  176],
    [ 356,   -1,   -1,   -1,   -1,  205,   -1,   -1,   -1,   -1,   -1,   -1,   -1,   -1,   -1,   -1,   -1,   -1,   -1,   -1,   -1,   -1,   -1,  206,   -1,   -1,   -1,   -1,  372],
    [  -1,   -1,   -1,   -1,   -1,  205,   -1,   -1,   -1,   -1,   -1,   -1,   -1,   -1,   -1,   -1,   -1,   -1,   -1,   -1,   -1,   -1,   -1,  206,   -1,   -1,   -1,   -1,  432],
    [  -1,   -1,   -1,   -1,   -1,  205,   -1,   -1,   -1,   -1,   -1,   -1,   -1,   -1,   -1,   -1,   -1,   -1,   -1,   -1,   -1,   -1,   -1,  206,   -1,   -1,   -1,   -1,  478],
    [  -1,   -1,   -1,   -1,   -1,  205,   -1,   -1,   -1,   -1,   -1,   -1,   -1,   -1,   -1,   -1,   -1,   -1,   -1,   -1,   -1,   -1,   -1,  206,   -1,   -1,   -1,   -1,   -1],
    [  -1,   -1,   -1,   -1,   -1,  108,   -1,   -1,   -1,   -1,   -1,   -1,   -1,   -1,   -1,   -1,   -1,   -1,   -1,   -1,   -1,   -1,   -1,   26,   -1,   -1,   -1,   -1,   -1],
    [  -1,   -1,   -1,   -1,   -1,  138,   -1,   -1,   -1,   -1,   -1,   -1,   -1,   -1,   -1,   -1,   -1,   -1,   -1,   -1,   -1,   -1,   -1,   56,   -1,   -1,   -1,   -1,   -1],
    [  -1,   -1,   -1,   -1,   -1,   -1,   -1,   -1,   -1,   -1,   -1,   -1,   -1,   -1,   -1,   -1,   -1,   -1,   -1,   -1,   -1,   -1,   -1,   -1,   -1,   -1,   -1,   -1,   -1],
    [  -1,   -1,   -1,   -1,   -1,   -1,   -1,   -1,   -1,   -1,   -1,   -1,   -1,   -1,   -1,   -1,   -1,   -1,   -1,   -1,   -1,   -1,   -1,   -1,   -1,   -1,   -1,   -1,   -1],
    [  -1,   -1,   -1,   -1,   -1,   -1,   -1,   -1,   -1,   -1,   -1,   -1,   -1,   -1,   -1,   -1,   -1,   -1,   -1,   -1,   -1,   -1,   -1,   -1,   -1,   -1,   -1,   -1,   -1],
    [  -1,   -1,   -1,   -1,   -1,  168,   -1,   -1,   -1,   -1,   -1,   -1,   -1,   -1,   -1,   -1,   -1,   -1,   -1,   -1,   -1,   -1,   -1,  445,   -1,   -1,   -1,   -1,   -1],
    [  -1,   -1,   -1,   -1,   -1,  198,   -1,   -1,   -1,   -1,   -1,   -1,   -1,   -1,   -1,   -1,   -1,   -1,   -1,   -1,   -1,   -1,   -1,  475,   -1,   -1,   -1,   -1,   -1],
    [  -1,   -1,   -1,   -1,   -1,  205,   -1,   -1,   -1,   -1,   -1,   -1,   -1,   -1,   -1,   -1,   -1,   -1,   -1,   -1,   -1,   -1,   -1,  206,   -1,   -1,   -1,   -1,   -1],
    [ 326,   -1,   -1,   -1,   -1,  205,   -1,   -1,   -1,   -1,   -1,   -1,   -1,   -1,   -1,   -1,   -1,   -1,   -1,   -1,   -1,   -1,   -1,  206,   -1,   -1,   -1,   -1,  323],
    [ 356,   -1,   -1,   -1,   -1,  205,   -1,   -1,   -1,   -1,   -1,   -1,   -1,   -1,   -1,   -1,   -1,   -1,   -1,   -1,   -1,   -1,   -1,  206,   -1,   -1,   -1,   -1,  353],
    [  -1,   -1,   -1,   -1,   -1,  205,   -1,   -1,   -1,   -1,   -1,   -1,   -1,   -1,   -1,   -1,   -1,   -1,   -1,   -1,   -1,   -1,   -1,  206,   -1,   -1,   -1,   -1,  323],
    [  -1,   -1,   -1,   -1,   -1,  205,   -1,   -1,   -1,   -1,   -1,   -1,   -1,   -1,   -1,   -1,   -1,   -1,   -1,   -1,   -1,   -1,   -1,  206,   -1,   -1,   -1,   -1,  353],
    [  -1,   -1,   -1,   -1,   -1,   27,   -1,   -1,   -1,   -1,   -1,   -1,   -1,   -1,   -1,   -1,   -1,   -1,   -1,   -1,   -1,   -1,   -1,   29,   -1,   -1,   -1,   -1,   -1],
    [  -1,   -1,   -1,   -1,   -1,   57,  238,  238,  238,  238,  238,   59,   -1,   -1,   -1,   -1,   -1,   57,  238,  238,  238,  238,  238,   59,   -1,   -1,   -1,   -1,   -1],
    [  -1,   -1,   -1,   -1,   -1,   -1,   -1,   -1,   -1,   -1,   -1,   -1,   -1,   -1,   -1,   -1,   -1,   -1,   -1,   -1,   -1,   -1,   -1,   -1,   -1,   -1,   -1,   -1,   -1],
    [  -1,   -1,   -1,   -1,   -1,   -1,   -1,   -1,   -1,   -1,   -1,   -1,   -1,   -1,   -1,   -1,   -1,   -1,   -1,   -1,   -1,   -1,   -1,   -1,   -1,   -1,   -1,   -1,   -1],
    [  -1,   -1,   -1,   -1,   -1,   -1,   -1,   -1,   -1,   -1,   -1,   -1,   -1,   -1,   -1,   -1,   -1,   -1,   -1,   -1,   -1,   -1,   -1,   -1,   -1,   -1,   -1,   -1,   -1],
    [ 353,   -1,  372,  373,  373,  374,   -1,   -1,   -1,   -1,   -1,   -1,   -1,   -1,   -1,   -1,   -1,   -1,   -1,   -1,   -1,   -1,   -1,   -1,   -1,   -1,   -1,  470,  471]
  ],
  "couche2": [
    [  -1,   -1,   -1,   -1,   -1,   -1,   -1,   -1,   -1,   -1,   -1,   -1,   -1,   -1,   -1,   -1,   -1,   -1,   -1,   -1,   -1,   -1,   -1,   -1,   -1,   -1,   -1,   -1,   -1],
    [  -1,   -1,   -1,   -1,   -1,   -1,   -1,   -1,   -1,   -1,   -1,   -1,   -1,   -1,   -1,   -1,   -1,   -1,   -1,   -1,   -1,   -1,   -1,   -1,   -1,   -1,   -1,   -1,   -1],
    [  -1,   -1,   -1,   -1,   -1,   -1,   -1,   -1,   -1,   -1,   -1,   -1,   -1,   -1,   -1,   -1,   -1,   -1,   -1,   -1,   -1,   -1,   -1,   -1,   -1,   -1,   -1,   -1,   -1],
    [  -1,  382,   -1,   -1,   -1,   -1,   -1,   -1,   -1,   -1,   -1,   -1,   -1,   -1,   -1,   -1,   -1,   -1,   -1,   -1,   -1,   -1,   -1,   -1,   -1,   -1,   -1,   -1,   -1],
    [  -1,   -1,   -1,   -1,   -1,   -1,   -1,   -1,   -1,   -1,   -1,   -1,   -1,   -1,   -1,   -1,   -1,   -1,   -1,   -1,   -1,   -1,   -1,   -1,   -1,   -1,   -1,   -1,   -1],
    [  -1,   -1,   -1,   -1,   -1,   -1,   -1,   -1,   -1,   -1,   -1,   -1,   -1,   -1,   -1,   -1,   -1,   -1,   -1,   -1,   -1,   -1,   -1,   -1,   -1,   -1,   -1,   -1,   -1],
    [  -1,   -1,   -1,   -1,   -1,  207,  208,  208,  208,  208,  208,  209,   -1,   -1,   -1,   -1,   -1,  207,  208,  208,  208,  208,  208,  209,   -1,   -1,   -1,   -1,   -1],
    [  -1,   -1,   -1,   -1,   -1,   -1,   -1,   -1,   -1,   -1,   -1,   -1,   -1,   -1,   -1,   -1,   -1,   -1,   -1,   -1,   -1,   -1,   -1,   -1,   -1,   -1,   -1,   -1,   -1],
    [  -1,   -1,   -1,   -1,   -1,   -1,   -1,   -1,   -1,   -1,   -1,   -1,   -1,   -1,   -1,   -1,   -1,   -1,   -1,   -1,   -1,   -1,   -1,   -1,   -1,   -1,   -1,   -1,   -1],
    [  -1,   -1,   -1,   -1,   -1,   -1,   -1,   -1,   -1,   -1,   -1,   -1,   -1,   -1,   -1,   -1,   -1,   -1,   -1,   -1,   -1,   -1,   -1,   -1,   -1,   -1,   -1,   -1,   -1],
    [  -1,   -1,   -1,   -1,   -1,   -1,   -1,   -1,   -1,   -1,   -1,   -1,   -1,   -1,   -1,   -1,   -1,   -1,   -1,   -1,   -1,   -1,   -1,   -1,   -1,   -1,   -1,   -1,   -1],
    [  -1,   -1,   -1,   -1,   -1,   -1,   -1,   -1,   -1,   -1,   -1,   -1,   -1,   -1,   -1,   -1,   -1,   -1,   -1,   -1,   -1,   -1,   -1,   -1,   -1,   -1,   -1,   -1,   -1],
    [  -1,   -1,   -1,   -1,   -1,   -1,   -1,   -1,   -1,   -1,   -1,   -1,   -1,   -1,   -1,   -1,   -1,   -1,   -1,   -1,   -1,   -1,   -1,   -1,   -1,   -1,   -1,   -1,   -1],
    [  -1,   -1,   -1,   -1,   -1,   -1,   -1,   -1,   -1,   -1,   -1,   -1,   -1,   -1,   -1,   -1,   -1,   -1,   -1,   -1,   -1,   -1,   -1,   -1,   -1,   -1,   -1,   -1,   -1],
    [  -1,   -1,   -1,   -1,   -1,   -1,   -1,   -1,   -1,   -1,   -1,   -1,   -1,   -1,   -1,   -1,   -1,   -1,   -1,   -1,   -1,   -1,   -1,   -1,   -1,   -1,   -1,   -1,   -1],
    [  -1,   -1,   -1,   -1,   -1,   -1,   -1,   -1,   -1,   -1,   -1,   -1,   -1,   -1,   -1,   -1,   -1,   -1,   -1,   -1,   -1,   -1,   -1,   -1,   -1,   -1,   -1,   -1,   -1],
    [  -1,   -1,   -1,   -1,   -1,   -1,   -1,   -1,   -1,   -1,   -1,   -1,   -1,   -1,   -1,   -1,   -1,   -1,   -1,   -1,   -1,   -1,   -1,   -1,   -1,   -1,   -1,   -1,   -1],
    [  -1,   -1,   -1,   -1,   -1,   -1,   -1,   -1,   -1,   -1,   -1,   -1,   -1,   -1,   -1,   -1,   -1,   -1,   -1,   -1,   -1,   -1,   -1,   -1,   -1,   -1,   -1,   -1,   -1],
    [  -1,   -1,   -1,   -1,   -1,   -1,   -1,   -1,   -1,   -1,   -1,   -1,   -1,   -1,   -1,   -1,   -1,   -1,   -1,   -1,   -1,   -1,   -1,   -1,   -1,   -1,   -1,   -1,   -1],
    [  -1,   -1,   -1,   -1,   -1,   -1,   -1,   -1,   -1,   -1,   -1,   -1,   -1,   -1,   -1,   -1,   -1,   -1,   -1,   -1,   -1,   -1,   -1,   -1,   -1,   -1,   -1,   -1,   -1],
    [  -1,   -1,   -1,   -1,   -1,   -1,   -1,   -1,   -1,   -1,   -1,   -1,   -1,   -1,   -1,   -1,   -1,   -1,   -1,   -1,   -1,   -1,   -1,   -1,   -1,   -1,   -1,   -1,   -1],
    [  -1,   -1,   -1,   -1,   -1,   -1,   -1,   -1,   -1,   -1,   -1,   -1,   -1,   -1,   -1,   -1,   -1,   -1,   -1,   -1,   -1,   -1,   -1,   -1,   -1,   -1,   -1,   -1,   -1],
    [  -1,   -1,   -1,   -1,   -1,   -1,   -1,   -1,   -1,   -1,   -1,   -1,   -1,   -1,   -1,   -1,   -1,   -1,   -1,   -1,   -1,   -1,   -1,   -1,   -1,   -1,   -1,   -1,   -1],
    [  -1,   -1,   -1,   -1,   -1,   -1,   -1,   -1,   -1,   -1,   -1,   -1,   -1,   -1,   -1,   -1,   -1,   -1,   -1,   -1,   -1,   -1,   -1,   -1,   -1,   -1,   -1,   -1,   -1],
    [  -1,   -1,   -1,   -1,   -1,   -1,   -1,   -1,   -1,   -1,   -1,   -1,   -1,   -1,   -1,   -1,   -1,   -1,   -1,   -1,   -1,   -1,   -1,   -1,   -1,   -1,   -1,   -1,   -1],
    [  -1,   -1,   -1,   -1,   -1,   -1,   -1,   -1,   -1,   -1,   -1,   -1,   -1,   -1,   -1,   -1,   -1,   -1,   -1,   -1,   -1,   -1,   -1,   -1,   -1,   -1,   -1,   -1,   -1],
    [  -1,   -1,   -1,   -1,   -1,   -1,  208,  208,  208,  208,  208,  209,   -1,   -1,   -1,   -1,   -1,  207,  208,  208,  208,  208,  208,   -1,   -1,   -1,   -1,   -1,   -1],
    [  -1,   -1,   -1,   -1,   -1,   -1,   -1,   -1,   -1,   -1,   -1,   -1,   -1,   -1,   -1,   -1,   -1,   -1,   -1,   -1,   -1,   -1,   -1,   -1,   -1,   -1,   -1,   -1,   -1],
    [  -1,   -1,   -1,   -1,   -1,   -1,   -1,   -1,   -1,   -1,   -1,   -1,   -1,   -1,   -1,   -1,   -1,   -1,   -1,   -1,   -1,   -1,   -1,   -1,   -1,   -1,   -1,   -1,   -1],
    [  -1,   -1,   -1,   -1,   -1,   -1,   -1,   -1,   -1,   -1,   -1,   -1,   -1,   -1,   -1,   -1,   -1,   -1,   -1,   -1,   -1,   -1,   -1,   -1,   -1,   -1,   -1,   -1,   -1],
    [ 323,   -1,   -1,  329,   -1,   -1,   -1,   -1,   -1,   -1,   -1,   -1,   -1,   -1,   -1,   -1,   -1,   -1,   -1,   -1,   -1,   -1,   -1,   -1,   -1,   -1,   -1,  440,  441],
    [  -1,   -1,   -1,  359,   -1,   -1,   -1,   -1,   -1,   -1,   -1,   -1,   -1,   -1,   -1,   -1,   -1,   -1,   -1,   -1,   -1,   -1,   -1,   -1,   -1,   -1,   -1,   -1,   -1]
  ]
}