  -1  438  439   -1   -1   -1   -1  443   -1   -1   -1   -1  446   -1   -1   -1  446   -1   -1   -1   -1  383   -1   -1   -1  406  407   -1   -1 
  -1  468  469   -1   -1  417   -1  473   -1   -1   -1   -1  476   -1   -1   -1  476   -1   -1   -1   -1   -1  413   -1   -1  436  437   -1  412 
  -1   -1   -1   -1   -1  447   -1  388   -1   -1   -1  323   -1   -1   -1   -1   -1   -1   -1  388   -1   -1   -1  388   -1  466  467   -1  442 
 389  327  328  449   -1  477   -1  418   -1   -1   -1  353   -1   -1   -1   -1   -1   -1   -1  418   -1   -1   -1  418   -1   -1   -1   -1  472 
 419  357  358  479   -1   -1   -1   -1   -1   -1   -1   -1   -1   -1   -1   -1   -1   -1   -1   -1   -1   -1   -1   -1   -1   -1   -1   -1   -1 
  -1   -1   -1   -1   -1   -1   -1   -1   -1   -1   -1   -1   -1   -1   -1   -1   -1   -1   -1   -1   -1   -1   -1   -1   -1   -1   -1   -1   -1 
  -1   -1   -1   -1   -1   -1   -1   -1   -1   -1   -1   -1   -1   -1   -1   -1   -1   -1   -1   -1   -1   -1   -1   -1   -1   -1   -1   -1   -1 
  -1   -1   -1   -1   -1  237  238  238  238  238  238   59   -1   -1   -1   -1   -1   57  238  238  238  238  238  239   -1   -1   -1   -1   -1 
  -1   -1   -1   -1   -1  205   -1   -1   -1   -1   -1   -1   -1   -1   -1   -1   -1   -1   -1   -1   -1   -1   -1  206   -1   -1   -1   -1  146 
 326   -1   -1   -1   -1  205   -1   -1   -1   -1   -1   -1   -1   -1   -1   -1   -1   -1   -1   -1   -1   -1   -1  206   -1   -1   -1   -1  176 
 356   -1   -1   -1   -1  205   -1   -1   -1   -1   -1   -1   -1   -1   -1   -1   -1   -1   -1   -1   -1   -1   -1  206   -1   -1   -1   -1  372 
  -1   -1   -1   -1   -1  205   -1   -1   -1   -1   -1   -1   -1   -1   -1   -1   -1   -1   -1   -1   -1   -1   -1  206   -1   -1   -1   -1  432 
  -1   -1   -1   -1   -1  205   -1   -1   -1   -1   -1   -1   -1   -1   -1   -1   -1   -1   -1   -1   -1   -1   -1  206   -1   -1   -1   -1  478 
  -1   -1   -1   -1   -1  205   -1   -1   -1   -1   -1   -1   -1   -1   -1   -1   -1   -1   -1   -1   -1   -1   -1  206   -1   -1   -1   -1   -1 
  -1   -1   -1   -1   -1  108   -1   -1   -1   -1   -1   -1   -1   -1   -1   -1   -1   -1   -1   -1   -1   -1   -1   26   -1   -1   -1   -1   -1 
  -1   -1   -1   -1   -1  138   -1   -1   -1   -1   -1   -1   -1   -1   -1   -1   -1   -1   -1   -1   -1   -1   -1   56   -1   -1   -1   -1   -1 
  -1   -1   -1   -1   -1   -1   -1   -1   -1   -1   -1   -1   -1   -1   -1   -1   -1   -1   -1   -1   -1   -1   -1   -1   -1   -1   -1   -1   -1 
  -1   -1   -1   -1   -1   -1   -1   -1   -1   -1   -1   -1   -1   -1   -1   -1   -1   -1   -1   -1   -1   -1   -1   -1   -1   -1   -1   -1   -1 
  -1   -1   -1   -1   -1   -1   -1   -1   -1   -1   -1   -1   -1   -1   -1   -1   -1   -1   -1   -1   -1   -1   -1   -1   -1   -1   -1   -1   -1 
  -1   -1   -1   -1   -1  168   -1   -1   -1   -1   -1   -1   -1   -1   -1   -1   -1   -1   -1   -1   -1   -1   -1  445   -1   -1   -1   -1   -1 
  -1   -1   -1   -1   -1  198   -1   -1   -1   -1   -1   -1   -1   -1   -1   -1   -1   -1   -1   -1   -1   -1   -1  475   -1   -1   -1   -1   -1 
  -1   -1   -1   -1   -1  205   -1   -1   -1   -1   -1   -1   -1   -1   -1   -1   -1   -1   -1   -1   -1   -1   -1  206   -1   -1   -1   -1   -1 
 326   -1   -1   -1   -1  205   -1   -1   -1   -1   -1   -1   -1   -1   -1   -1   -1   -1   -1   -1   -1   -1   -1  206   -1   -1   -1   -1  323 
 356   -1   -1   -1   -1  205   -1   -1   -1   -1   -1   -1   -1   -1   -1   -1   -1   -1   -1   -1   -1   -1   -1  206   -1   -1   -1   -1  353 
  -1   -1   -1   -1   -1  205   -1   -1   -1   -1   -1   -1   -1   -1   -1   -1   -1   -1   -1   -1   -1   -1   -1  206   -1   -1   -1   -1  323 
  -1   -1   -1   -1   -1  205   -1   -1   -1   -1   -1   -1   -1   -1   -1   -1   -1   -1   -1   -1   -1   -1   -1  206   -1   -1   -1   -1  353 
  -1   -1   -1   -1   -1   27   -1   -1   -1   -1   -1   -1   -1   -1   -1   -1   -1   -1   -1   -1   -1   -1   -1   29   -1   -1   -1   -1   -1 
  -1   -1   -1   -1   -1   57  238  238  238  238  238   59   -1   -1   -1   -1   -1   57  238  238  238  238  238   59   -1   -1   -1   -1   -1 
  -1   -1   -1   -1   -1   -1   -1   -1   -1   -1   -1   -1   -1   -1   -1   -1   -1   -1   -1   -1   -1   -1   -1   -1   -1   -1   -1   -1   -1 
  -1   -1   -1   -1   -1   -1   -1   -1   -1   -1   -1   -1   -1   -1   -1   -1   -1   -1   -1   -1   -1   -1   -1   -1   -1   -1   -1   -1   -1 
  -1   -1   -1   -1   -1   -1   -1   -1   -1   -1   -1   -1   -1   -1   -1   -1   -1   -1   -1   -1   -1   -1   -1   -1   -1   -1   -1   -1   -1 
 353   -1  372  373  373  374   -1   -1   -1   -1   -1   -1   -1   -1   -1   -1   -1   -1   -1   -1   -1   -1   -1   -1   -1   -1   -1  470  471 