 225  227  227  385  227  227  227  227  227  385  227  227  227  349  350  351  227  227  227  385  227  227  227  227  227  121  121  227  228 
 255  257  257  415  257  257  257  257  257  415  257  257  257  379  380  381  257  257  257  415  257  257  257  257  257  151  151  257  258 
 285  287  287  287  287  287  287  287  287  287  287  287  287  409  410  411  287  287  287  287  287  287  287  287  287  181  181  287  288 
 365  365    3    4    5  365  365  365    3    4    5  365  365  261  262  318  365  365    3    4    5  365  365  365  365  365  365  365  365 
 365  365   33   34   35  365  365  365   33   34   35  365  365  291  292  348  365  365   33   34   35  365  365  365  365  365   62   62  365 
 253  254  365  365  365  365  365  365  365  365  365  365  365  365  365  365  365  365  365  365  365  365  365  365  365  365   62  313  314 
 283  284  365  365  365  365  365  365  365  365  365  365  365  365  365  365  365  365  365  365  365  365  365  365  365  365   60  343  344 
 365  365  365  365  365  365  365  365  365  365  365  365  365  365  365  365  365  365  365  365  365  365  365  365  365  365  365   62  365 
 365  365  365  365  365  195  259  260  259  260  259  260  259  260  259  260  259  260  259  260  259  260  259  197  365  365  365  365  365 
 365  365  365  365  365  165  229  230  229  230  229  230  229  230  229  230  229  230  229  230  229  230  229  167  365  365  365  365  365 
 365  365  365  365  365  195  259  260  259  260  259  260  259  260  259  260  259  260  259  260  259  260  259  197  365  365  365  365  335 
 365  365  365  365  365  165  229  230  229  230  229  230  229  230  229  230  229  230  229  230  229  230  229  167  365   62   62  365  365 
 365  365  365  365  365  195  259  260  259  260  259  260  259  260  259  260  259  260  259  260  259  260  259  197  365  365   62  365  365 
 365  365  365  365  365  165  229  230  229  230  229  230  229  230  229  230  229  230  229  230  229  230  229  167  365  365   62  365  365 
 253  254  365  365  365  195  259  260  259  260  259  260  259  260  259  260  259  260  259  260  259  260  259  197  365  365   62  313  314 
 221  284  365  365  365  165  229  230  229  230  229  230  229  230  229  230  229  230  229  230  229  230  229  167  365  365   62  343  338 
 251  252  365  365  365  195  259  260  259  260  259  260  259  260  259  260  259  260  259  260  259  260  259  197  365  365  365  367  368 
 281  282  365  365  365  165  229  230  229  230  229  230  229  230  229  230  229  230  229  230  229  230  229  167  365  365  365  397  398 
 311  312  365  365  365  195  259  260  259  260  259  260  259  260  259  260  259  260  259  260  259  260  259  197  365  365  365  427  428 
 341  254  365  365  365  165  229  230  229  230  229  230  229  230  229  230  229  230  229  230  229  230  229  167  365  365   62  313  458 
 283  284  365  365  365  195  259  260  259  260  259  260  259  260  259  260  259  260  259  260  259  260  259  197  365  365   62  343  344 
 365  365  365  365  365  165  229  230  229  230  229  230  229  230  229  230  229  230  229  230  229  230  229  167  365  365  365  365  365 
 365  365  365  365  365  195  259  260  259  260  259  260  259  260  259  260  259  260  259  260  259  260  259  197  365  365  365  365  365 
 365  365  365  365  365  165  229  230  229  230  229  230  229  230  229  230  229  230  229  230  229  230  229  167  365  365  365  365  365 
 365  365  365  365  365  195  259  260  259  260  259  260  259  260  259  260  259  260  259  260  259  260  259  197  365  365  365  365  365 
 365  365  365  365  365  165  229  230  229  230  229  230  229  230  229  230  229  230  229  230  229  230  229  167  365  365  365  365  365 
 365  365  365  365  365  195  259  260  259  260  259  260  259  260  259  260  259  260  259  260  259  260  259  197  365  365  365  365  365 
 253  254  365  365  365  165  229  230  229  230  229  230  229  230  229  230  229  230  229  230  229  230  229  167  365  365  365  313  314 
 283  284  365  365  365  365  365  365  365  365  365  365  365  365  365  365  365  365  365  365  365  365  365  365  365  365  365  343  344 
 365  365  365  365  365  365  365  365  365  365  365  365  390  391  392  393  394  365  365  365  365  365  365  365  365  365  365  365  365 
 365  365  365  365  365  365  365  365  365  365  365  365  420  421  422  423  424  365  365  365  365  365  365  365  365  365  365  365  365 
 365  365  365  365  365  365  365  365  365  365  365  365  450  451  452  453  454  365  365  365  365  365  365  365  365  365  365  365  365 