  -1   -1   -1   -1   -1  280  526  526  526  526  526  526  526  281   -1   -1   -1   -1   -1 
  -1   -1   -1   -1   -1  492  144  276  145  145  145  276  146  490   -1   -1   -1   -1   -1 
  -1   -1   -1   -1   -1  492  179  311  180  180  180  311  181  490   -1   -1   -1   -1   -1 
  -1   -1   -1   -1   -1  492  214  346  215  215  215  346  216  490   -1   -1   -1   -1   -1 
  -1   -1   -1   -1   -1  492  120  121  121  121  121  121  122  490   -1   -1   -1   -1   -1 
  -1   -1  280  526  526  527  155  156  156  156  156  156  157  525  526  526  281   -1   -1 
  -1   -1  492  145  276  146  190  191  191  191  191  191  192  144  276  146  490   -1   -1 
  -1   -1  492  180  311  181  225  226  226  226  226  226  227  179  311  180  490   -1   -1 
 280  526  527  215  346  216  120  121  121  121  121  121  122  214  346  215  525  526  281 
 492  276  146  224  224  224  155  156  156  156  156  156  157  224  224  224  144  276  490 
 492  311  181  224  224  224  155  156  156  156  156  156  157  224  224  224  179  311  490 
 492  346  216  224  224  224  155  156  156  156  156  156  157  224  224  224  214  346  490 
 492  224  224  224  224  224  155  156  156  156  156  156  157  224  224  224  224  224  490 
 492  224  224  224  224  224  155  156  156  156  156  156  157  224  224  224  224  224  490 
 492  224  224  224  224  224  155  156  156  156  156  156  157  224  224  224  224  224  490 
 492  224  224  224  224  224  155  156  156  156  156  156  157  224  224  224  224  224  490 
 492  224  224  224  224  224  155  156  156  156  156  156  157  224  224  224  224  224  490 
 315  456  457  224  224  224  155  156  156  156  156  156  157  224  224  224  455  456  316 
  -1   -1  315  456  456  456  456  457  156  156  156  455  456  456  456  456  316   -1   -1 
  -1   -1   -1   -1   -1   -1   -1  492  156  156  156  490   -1   -1   -1   -1   -1   -1   -1 
  -1   -1   -1   -1   -1   -1   -1  492  156  156  156  490   -1   -1   -1   -1   -1   -1   -1 
  -1   -1   -1   -1   -1   -1   -1  315  456  456  456  316   -1   -1   -1   -1   -1   -1   -1 