 280  526  526  526  526  526  526  526  526  526  526  526  526  526  281 
 492   57   57   57   57   57   57   57   57   57   57   57   57   57  490 
 492   57   57   57   57   57   57   57   57   57   57   57   57   57  490 
 492   92   92   92   92   92   92   92   92   92   92   92   92   92  490 
 527  357  357  357  358  360  360  360  360  360  356  357  357  357  525 
  58  357  357  357  358  360  360  360  360  360  356  357  357  357   58 
  58  357  357  357  358  360  360  360  360  360  356  357  357  357   58 
  58  357  357  357  358  360  360  360  360  360  356  357  357  357   58 
 357  357  357  357  358  360  360  360  360  360  356  357  357  357  357 
 114  357  357  357  358  360  360  360  360  360  356  357  357  357  256 
  58  357  357  357  358  360  360  360  360  360  356  357  357  357   58 
  58  357  357  357  358  360  360  360  360  360  356  357  357  357   58 
  58  357  357  357  358  360  360  360  360  360  356  357  357  357   58 
  58  357  357  357  358  360  360  360  360  360  356  357  357  357   58 
 357  357  357  357  358  360  360  360  360  360  356  357  357  357  357 
 457  357  357  357  358  360  360  360  360  360  356  357  357  357  455 
 315  456  456  456  457  360  360  360  360  360  455  456  456  456  316 
  -1   -1   -1   -1  492  360  360  360  360  360  490   -1   -1   -1   -1 
  -1   -1   -1   -1  492  360  360  360  360  360  490   -1   -1   -1   -1 
  -1   -1   -1   -1  492  360  360  360  360  360  490   -1   -1   -1   -1 