 139  140  140  140  140  140  140  140  140  140  140  140  140  140  140  140  140  140  140  140  140  140  140  140  295  295  295  140  140  140  140  140  140  140  140  140  140  140  140  140  140  140  140  140  140  140  140  140  140  141 
 175  498  499  499  499  499  499  499  499  499  499  499  499  499  499  499  499  499  499  499  499  499  499  499   81   82   83  499  499  499  499  499  499  499  499  499  499  499  499  499  499  499  499  499  499  499  499  499  500   67 
 175  534  535  535  535  535  535  535  535  535  535  535  535  535  535  535  535  535  535  535  535  535  535  535   81   82   83  535  535  535  535  535  535  535  535  535  535  535  535  535  535  535  535  535  535  535  535  535  536   67 
 175  570  571  571  571  571  571  571  571  571  571  571  571  571  571  571  571  571  571  571  571  571  571  571   81   82   83  571  571  571  571  571  571  571  571  571  571  571  571  571  571  571  571  571  571  571  571  571  572   67 
 175  295   42   44  295  295  295  295  294  295  295  295  295    7    6  294  436  436  436  295  294  295  295   45   82   82   82   47  295    9  295   42   42   44  295  295  294  295  471  508  508  508  508  508  508  508  508  473   10   67 
 175  294   78   79   44  295  139  140  140  140  140  140  141  436  436  436  436  150  436  295  295  295   45   82   82   82   82   82   47  295    6   42   79  116   10  294   10   10  139  140  140  140  140  140  141  508  508  509   10   67 
 175  295   78   79   79   44  175   91   91   91   91   91  177  473  436  294  436  436    6  295  295  295   81   82   82   82   82   82   83  295  295  114  115  295  442  295    6  295  175   91   91   91   91   91  177  508  508  509   10   67 
 175   42   79   79   79   80  175   91   91   91   91   91  103  140  140  140  140  140  140  140  140  140  140  140  140  140  140  140  140  140  140  140  140  140  140  140  140  140  105   91   91   91   91   91  177  508  508  509   10   67 
 175   78   79   79   79   80  175   91   91   91   91   91   91   91   91   91   91   91   91   91   91   91   91   91   91   91   91   91   91   91   91   91   91   91   91   91   91   91   91   91   91   91   91   91  177  508  508  509   10   67 
 175   78   79   79  115  116  175   91   91   91   91   91  139  140  140  140  140  140  140  140  140  140  140  140  140  140  140  140  140  140  140  140  140  140  140  140  140  140  141   91   91   91   91   91  177  508  508  509   10   67 
 175  114  115  116   10   10  211   91   91   91   91   91  175   55   55   55   55   55   55   55   55   55   55   55   55   55   55   55   55   55   55   55   55   55   55   55   55   55  177   91   91   91   91   91  213  508  508  509   10   67 
 175    6  433   10  330  332  247   32   32   91   91   91  175   55   55   55   55   55   55   55   55   55   55   55   55   55   55   55   55   55   55   55   55   55   55   55   55   55  177   91   91   91  248  248  249  508  508  509   10   67 
 175  433  433  330  367  368  498  499  499  175   91   91  175   55   55   55   55   55   55   55   55   55   55   55   55   55   55   55   55   55   55   55   55   55   55   55   55   55  177   91   91  177  499  499  500  508  508  509   10   67 
 175  330  332  367  296  404  534  535  535  175   91   91  175  129  130  131   92   55   55   55   55   55   55   55   55   55   55   55   55   55   55   55   55   55   55   55   55   55  177   91   91  177  535  535  536  508  508  545   10   67 
 175  366  367  367  404   10  534  535  535  175   91   91  126  248  248  248  127  248  248  248  248  248  248  248  248  248  248  248  248  248  248  248  248  248  248  248  248  248  128   91   91  177  535  535  536  508  545   10   10   67 
 175  402  403  404  295    6  570  571  571  175   91   91  498  499  499  499  499  499  499  499  499  499  499  499  499  499  499  499  499  499  499  499  499  499  499  499  499  499  499   91   91  177  571  571  572  545   10  330  332   67 
 175  433  433   10  294   10   10   10   10  175   91   91  534  535  535  535  535  535  535  535  535  535  535  535  535  535  535  535  535  535  535  535  535  535  535  535  535  535  535   91   91  177  370  371  509   10  330  403  404   67 
 175  433  433  442   10  150    6   10   10  175   91   91  534  535  535  535  535  535  535  535  535  535  535  535  535  535  535  535  535  535  535  535  535  535  535  535  535  535  535   91   91  177  370  371  508  473   10   10   10   67 
 175  468  469  470   10   10   10  294   10  175   91   91  498  499  499  499  499  499  499  499  499  499  499  499  499  499  499  499  499  499  499  499  499  499  499  499  499  499  500   91   91  177  370  407  508  508  473   10  294   67 
 175  505  505  505  470   10   10   10   10  175   91   91  534  535  535  535  535  535  535  535  535  535  535  535  535  535  535  535  535  535  535  535  535  535  535  535  535  535  536   91   91  177  407  508  508  508  508  473   10   67 
 175  505  505  505  506   10  139  140  140  105   91   91  534  535  535  535  535  535  535  535  535  535  535  535  535  535  535  535  535  535  535  535  535  535  535  535  535  535  536   91   91  103  140  140  141  508  508  509   10   67 
 175  505  505  505  506   10  175   91   91   91   91   91  570  571  571  571  571  571  571  571  571  571  571  571  571   91  571  571  571  571  571  571  571  571  571  571  571  571  572   91   91   91   91   91  177  508  508  509   10   67 
 175  505  505  505  542   10  175   91   91   91   91   91   91   91   91   91   91   91   91   91   91   91   91   91   91   91   91   91   91   91   91   91   91   91   91   91   91   91   91   91   91   91   91   91  177  508  508  509   10   67 
 175  540  505  506   10   10  175   91   91   91   91   91   91  248  248  248  248  248  248  248  248  248  175   91   91   91   91   91  177  248  248  248  248  248  248  248  248  248   91   91   91   91   91   91  177  335  508  509   10   67 
 175   10  504  506    6   10  175   91   91   91   91   91  177  499  499  499  499  499  499  499  499  499  175   91   91   91   91   91  177  499  499  499  499  499  499  499  499  499  175   91   91   91   91   91  177  371  508  509   10   67 
 175   10  504  506   10  150  211  389  175   91   91   91  213  535  535  535  535  535  535  535  535  535  211   91   91   91   91   91  213  535  535  535  535  535  535  535  535  535  211   91   91   91   91   91  213  371  508  509   10   67 
 175  294  504  506   10   10  247  248  248  248  248  248  249  535  535  535  535  535  535  535  535  535  247  248  248  248  248  248  249  535  535  535  535  535  535  535  535  535  247  248  248  248  248  248  249  371  508  509   10   67 
 175   10  504  506  294   10  498  499  499  499  499  499  500  571  571  571  571  571  571  571  571  571  498  499  499  499  499  499  500  571  571  571  571  571  571  571  571  571  498  499  499  499  499  499  500  371  508  509   10   67 
 175   10  504  506   10   10  534  535  535  535  535  535  536  370  370  407  508  508  508  545  436  436  534  535  535  535  535  535  536  508  297  508  508  508  508  545  436  150  534  535  535  535  535  535  536  407  508  545   10   67 
 211    6  540  505  470   10  534  535  535  535  535  535  536  406  407  508  297  508  545  436  436  150  534  535  535  535  535  535  536  508  508  508  297  508  545  436  436  436  534  535  535  535  535  535  536  508  545   10   10   67 
 175   10   10  540  505  470  570  571  571  571  571  571  572  544  544  544  544  545  436  436    6  436  570  571  571  571  571  571  572  544  544  544  544  545  436   10   10  294  570  571  571  571  571  571  572  545   10   10   10   67 
 175  331  332   10  540  505  469  469  469  469  469  469  469  469  469  469  470   10  442   10  294   10   10   10   81   82   83   10   10    9   10   10   10   10   10    6   10   10   10   10   10   10  442   10   10   10   10    6   10   67 
 175  367  367  332  150  540  541  541  541  541  541  541  541  505  505  505  505  470   10    9   10   10   10   45   82   82   82   47   10   10   10  150   10   10   10   10  294   10  442   10    6   10   10   10   10   10   10   10   10   67 
 211  367  367  367  331  331  332   10   10  442   10  294   10  540  541  541  541  542   10   10   45   46   46   82   82   82   82   82   46   46   47   10   10   10   10   10   10   10   10   10   10   10   10   10  294   10  442   10   10  213 
 247  248  248  248  248  248  248  248  248  248  248  248  248  248  248  248  248  248  248   -1   -1   -1   82   82   82   82   82   82   82   -1   -1   -1  248  248  248  248  248  248  248  248  248  248  248  248  248  248  248  248  248  249 