  -1   -1   -1   -1   -1   -1   -1   -1   -1   -1   -1   -1   -1   -1   -1 
 479  261  469  469  469  262   -1   -1   -1  261  469  469  469  262  479 
 514  296  504  504  504  297   -1   -1   -1  296  504  504  504  297  514 
  11  331  539  539  539  332  329   -1  330  331  539  539  539  332   10 
  46   -1   -1   -1   -1   -1   -1   -1   -1   -1   -1   -1   -1   -1   45 
  -1   -1   -1   -1   -1   -1   -1   -1   -1   -1   -1   -1   -1   -1   -1 
 479   -1   -1   -1   -1   -1   -1   -1   -1   -1   -1   -1   -1   -1  479 
 514   -1   -1   -1   -1   -1   -1   -1   -1   -1   -1   -1   -1   -1  514 
  -1   -1   -1   -1   -1   -1   -1   -1   -1   -1   -1   -1   -1   -1   -1 
  10   -1   -1   -1   -1   -1   -1   -1   -1   -1   -1   -1   -1   -1   11 
  45   -1   -1   -1  377  378   -1   -1   -1   -1  447   62   -1   -1   46 
  -1   -1   -1   -1   -1   -1   -1   -1   -1   -1   -1   -1   -1   -1   -1 