  -1   -1   -1   -1   -1   -1   -1   -1   -1   -1   -1   -1   -1   -1   -1   -1   -1   -1   -1 
  -1   -1   -1   -1   -1   -1  334  568  569  570  571  572  334   -1   -1   -1   -1   -1   -1 
  -1   -1   -1   -1   -1   -1  382  616  617  618  619  620  382   -1   -1   -1   -1   -1   -1 
  -1   -1   -1   -1   -1   -1  514  664  665  666  667  668  515   -1   -1   -1   -1   -1   -1 
  -1   -1   -1   -1   -1   -1  562  712  713  714  715  716  563   -1   -1   -1   -1   -1   -1 
  -1   -1   -1   -1   -1   -1   -1  314  315  316   -1  191   -1   -1   -1   -1   -1   -1   -1 
  -1   -1  573  574  575  334   -1  362  363  364   -1  239   -1  334  573  574  575   -1   -1 
  -1   -1  621  622  623  382   -1   -1   -1   -1   -1   -1   -1  382  621  622  623   -1   -1 
  -1   -1  669  670  671   -1   -1   -1   -1   -1   -1   -1   -1   -1  669  670  671   -1   -1 
  -1   -1  717  718  719   -1   -1   -1   -1   -1   -1   -1   -1   -1  717  718  719   -1   -1 
  -1   -1  325   -1   -1  131   -1   -1   -1   -1   -1   -1   -1  131   -1   -1  325   -1   -1 
  -1  512   -1   -1   -1   -1   -1   -1   -1   -1   -1   -1   -1   -1   -1   -1   -1  513   -1 
  -1  560   -1   -1   -1   -1   -1   -1   -1   -1   -1   -1   -1   -1   -1   -1   -1  561   -1 
  -1   -1   -1   -1   -1   -1   -1   -1   43   44   45   -1   -1   -1   -1   -1   -1   -1   -1 
  -1  231   -1   -1   -1  753   -1   -1   91   92   93   -1   -1  754   -1   -1   -1  230   -1 
  -1  279   -1   -1   -1   -1   -1   -1  139  140  141   -1   -1   -1   -1   -1   -1  278   -1 
  -1  327   -1   -1   -1   -1   -1   -1   -1   -1   -1   -1   -1   -1   -1   -1   -1  326   -1 
  -1   -1   -1   -1   -1  383   -1   -1   -1   -1   -1   -1   -1  383   -1   -1   -1   -1   -1 
  -1   -1   -1   -1   -1   -1   -1   -1   -1   -1   -1   -1   -1   -1   -1   -1   -1   -1   -1 
  -1   -1   -1   -1   -1   -1   -1   -1   -1   -1   -1   -1   -1   -1   -1   -1   -1   -1   -1 
  -1   -1   -1   -1   -1   -1   -1   -1   -1   -1   -1   -1   -1   -1   -1   -1   -1   -1   -1 
  -1   -1   -1   -1   -1   -1   -1   -1   -1   -1   -1   -1   -1   -1   -1   -1   -1   -1   -1 
  -1   -1   -1   -1   -1   -1   -1   -1   -1   -1   -1   -1   -1   -1   -1   -1   -1   -1   -1 