{
  "largeur": 15,
  "hauteur": 20,
  "chipset": "PalaisRoland2.png",
  "musique": "Castle_3.mp3",
  "couche0": [
    [ 280,  526,  526,  526,  526,  526,  526,  526,  526,  526,  526,  526,  526,  526,  281],
    [ 492,   57,   57,   57,   57,   57,   57,   57,   57,   57,   57,   57,   57,   57,  490],
    [ 492,   57,   57,   57,   57,   57,   57,   57,   57,   57,   57,   57,   57,   57,  490],
    [ 492,   92,   92,   92,   92,   92,   92,   92,   92,   92,   92,   92,   92,   92,  490],
    [ 527,  357,  357,  357,  358,  360,  360,  360,  360,  360,  356,  357,  357,  357,  525],
    [  58,  357,  357,  357,  358,  360,  360,  360,  360,  360,  356,  357,  357,  357,   58],
    [  58,  357,  357,  357,  358,  360,  360,  360,  360,  360,  356,  357,  357,  357,   58],
    [  58,  357,  357,  357,  358,  360,  360,  360,  360,  360,  356,  357,  357,  357,   58],
    [ 357,  357,  357,  357,  358,  360,  360,  360,  360,  360,  356,  357,  357,  357,  357],
    [ 114,  357,  357,  357,  358,  360,  360,  360,  360,  360,  356,  357,  357,  357,  256],
    [  58,  357,  357,  357,  358,  360,  360,  360,  360,  360,  356,  357,  357,  357,   58],
    [  58,  357,  357,  357,  358,  360,  360,  360,  360,  360,  356,  357,  357,  357,   58],
    [  58,  357,  357,  357,  358,  360,  360,  360,  360,  360,  356,  357,  357,  357,   58],
    [  58,  357,  357,  357,  358,  360,  360,  360,  360,  360,  356,  357,  357,  357,   58],
    [ 357,  357,  357,  357,  358,  360,  360,  360,  360,  360,  356,  357,  357,  357,  357],
    [ 457,  357,  357,  357,  358,  360,  360,  360,  360,  360,  356,  357,  357,  357,  455],
    [ 315,  456,  456,  456,  457,  360,  360,  360,  360,  360,  455,  456,  456,  456,  316],
    [  -1,   -1,   -1,   -1,  492,  360,  360,  360,  360,  360,  490,   -1,   -1,   -1,   -1],
    [  -1,   -1,   -1,   -1,  492,  360,  360,  360,  360,  360,  490,   -1,   -1,   -1,   -1],
    [  -1,   -1,   -1,   -1,  492,  360,  360,  360,  360,  360,  490,   -1,   -1,   -1,   -1]
  ],
  "couche1": [
    [  -1,   -1,   -1,   -1,   -1,   -1,   -1,   -1,   -1,   -1,   -1,   -1,   -1,   -1,   -1],
    [  -1,   -1,  479,   -1,  273,  274,   39,   40,   41,  273,  274,   -1,  479,   -1,   -1],
    [  -1,   -1,  514,   -1,   -1,   -1,   74,   75,   76,   -1,   -1,   -1,  514,   -1,   -1],
    [  -1,   -1,   -1,   -1,   -1,   -1,  109,  110,  111,   -1,   -1,   -1,   -1,   -1,   -1],
    [  -1,  407,   -1,   -1,   -1,   -1,   -1,   -1,   -1,  341,   -1,   -1,  535,  164,   -1],
    [  -1,  123,  124,  125,   -1,   -1,   -1,   -1,   -1,   -1,   -1,   -1,   -1,  199,   -1],
    [  -1,  193,  194,  195,  248,   -1,   -1,   -1,   -1,   -1,  248,   -1,   -1,  234,   -1],
    [  11,   -1,   -1,   -1,   -1,   -1,   -1,   -1,   -1,   -1,   -1,   -1,   -1,   -1,   10],
    [  46,   -1,   -1,   -1,   -1,   -1,   -1,   -1,   -1,   -1,   -1,   -1,   -1,   -1,   45],
    [  -1,   -1,   -1,   -1,   -1,   -1,   -1,   -1,   -1,   -1,   -1,   -1,   -1,   -1,   -1],
    [  -1,   -1,   -1,   -1,  248,   -1,   -1,   -1,   -1,   -1,  248,   -1,   -1,   -1,   -1],
    [  -1,   -1,   -1,   -1,   -1,   -1,   -1,   -1,   -1,   -1,   -1,   -1,   -1,   -1,   -1],
    [  -1,   -1,   -1,   -1,   -1,   -1,   -1,   -1,   -1,   -1,   -1,   -1,   -1,   -1,   -1],
    [  10,   -1,   -1,   -1,   -1,   -1,   -1,   -1,   -1,   -1,   -1,   -1,   -1,   -1,   11],
    [  45,   -1,   -1,   -1,  248,   -1,   -1,   -1,   -1,   -1,  248,   -1,   -1,   -1,   46],
    [  -1,   -1,   -1,   -1,   -1,   -1,   -1,   -1,   -1,   -1,   -1,   -1,   -1,   -1,   -1],
    [  -1,   -1,   -1,   -1,   -1,   -1,   -1,   -1,   -1,   -1,   -1,   -1,   -1,   -1,   -1],
    [  -1,   -1,   -1,   -1,   -1,   -1,   -1,   -1,   -1,   -1,   -1,   -1,   -1,   -1,   -1],
    [  -1,   -1,   -1,   -1,   -1,   -1,   -1,   -1,   -1,   -1,   -1,   -1,   -1,   -1,   -1],
    [  -1,   -1,   -1,   -1,   -1,   -1,   -1,   -1,   -1,   -1,   -1,   -1,   -1,   -1,   -1]
  ],
  "couche2": [
    [  -1,   -1,   -1,   -1,   -1,   -1,   -1,   -1,   -1,   -1,   -1,   -1,   -1,   -1,   -1],
    [  -1,   -1,   -1,   -1,   -1,   -1,   -1,   -1,   -1,   -1,   -1,   -1,   -1,   -1,   -1],
    [  -1,   -1,   -1,   -1,   -1,   -1,   -1,   -1,   -1,   -1,   -1,   -1,   -1,   -1,   -1],
    [  -1,   -1,   -1,   -1,  143,   -1,   -1,   -1,   -1,  306,  143,   -1,   -1,   29,   -1],
    [  -1,   -1,   -1,   -1,  178,   -1,   -1,   -1,   -1,   -1,  178,   -1,   -1,   64,   -1],
    [  -1,   62,   -1,   -1,  213,   -1,   -1,   -1,   -1,   -1,  213,   -1,   -1,   -1,   -1],
    [  -1,   -1,   -1,   -1,   -1,   -1,   -1,   -1,   -1,   -1,   -1,   -1,   -1,   -1,   -1],
    [  -1,   -1,   -1,   -1,  143,   -1,   -1,   -1,   -1,   -1,  143,   -1,   -1,   -1,   -1],
    [  -1,   -1,   -1,   -1,  178,   -1,   -1,   -1,   -1,   -1,  178,   -1,   -1,   -1,   -1],
    [  -1,   -1,   -1,   -1,  213,   -1,   -1,   -1,   -1,   -1,  213,   -1,   -1,   -1,   -1],
    [  -1,   28,   -1,   -1,   -1,   -1,   -1,   -1,   -1,   -1,   -1,   -1,   -1,   29,   -1],
    [  -1,   63,   -1,   -1,  143,   -1,   -1,   -1,   -1,   -1,  143,   -1,   -1,   64,   -1],
    [  -1,   -1,   -1,   -1,  178,   -1,   -1,   -1,   -1,   -1,  178,   -1,   -1,   -1,   -1],
    [  -1,   -1,   -1,   -1,  213,   -1,   -1,   -1,   -1,   -1,  213,   -1,   -1,   -1,   -1],
    [  -1,   -1,   -1,   -1,   -1,   -1,   -1,   -1,   -1,   -1,   -1,   -1,   -1,   -1,   -1],
    [  -1,   -1,   -1,   -1,   -1,   -1,   -1,   -1,   -1,   -1,   -1,   -1,   -1,   -1,   -1],
    [  -1,   -1,   -1,   -1,   -1,   -1,   -1,   -1,   -1,   -1,   -1,   -1,   -1,   -1,   -1],
    [  -1,   -1,   -1,   -1,   -1,   -1,   -1,   -1,   -1,   -1,   -1,   -1,   -1,   -1,   -1],
    [  -1,   -1,   -1,   -1,   -1,   -1,   -1,   -1,   -1,   -1,   -1,   -1,   -1,   -1,   -1],
    [  -1,   -1,   -1,   -1,   -1,   -1,   -1,   -1,   -1,   -1,   -1,   -1,   -1,   -1,   -1]
  ]
}