  -1   -1   -1   -1   -1   55  100  100  100  100  100  100  100   54   -1   -1   -1   -1   -1 
  -1   -1   -1   -1   -1   53  144  145  145  145  145  145  146   51   -1   -1   -1   -1   -1 
  -1   -1   -1   -1   -1   53  192  193  193  193  193  193  194   51   -1   -1   -1   -1   -1 
  -1   -1   -1   -1   -1   53  192  193  193  193  193  193  194   51   -1   -1   -1   -1   -1 
  -1   -1   -1   -1   -1   53  240  241  241  241  241  241  242   51   -1   -1   -1   -1   -1 
  -1   55  100  100  100  101    0    1    1    1    1    1    2   99  100  100  100   54   -1 
  -1   53  144  145  145  146   48   49   49   49   49   49   50  144  145  145  146   51   -1 
  -1   53  192  193  193  194   96   97   97   97   97   97   98  192  193  193  194   51   -1 
  -1   53  192  193  193  194  488  489  489  489  489  489  490  192  193  193  194   51   -1 
  55  101  240  241  241  242    0    1    1    1    1    1    2  240  241  241  242   99   54 
  53  146  733  733  733  733   48   49   49   49   49   49   50  733  733  733  733  144   51 
  53  194  733  733  733  733   48   49   49   49   49   49   50  733  733  733  733  192   51 
  53  242  733  733  733  733   48   49   49   49   49   49   50  733  733  733  733  240   51 
  53  733  733  733  733  733   48   49   49   49   49   49   50  733  733  733  733  733   51 
  53  733  733  733  733  733   48   49   49   49   49   49   50  733  733  733  733  733   51 
  53  733  733  733  733  733   48   49   49   49   49   49   50  733  733  733  733  733   51 
  53  733  733  733  733  733   48   49   49   49   49   49   50  733  733  733  733  733   51 
  53  733  733  733  733  733   48   49   49   49   49   49   50  733  733  733  733  733   51 
   7    4    5  733  733  733   96   97   49   49   49   97   98  733  733  733    3    4    6 
  -1   -1    7    4    4    4    4    5   48   49   50    3    4    4    4    4    6   -1   -1 
  -1   -1   -1   -1   -1   -1   -1   53   48   49   50   51   -1   -1   -1   -1   -1   -1   -1 
  -1   -1   -1   -1   -1   -1   -1   53   96   97   98   51   -1   -1   -1   -1   -1   -1   -1 
  -1   -1   -1   -1   -1   -1   -1    7    4    4    4    6   -1   -1   -1   -1   -1   -1   -1 