  -1   -1   -1   -1   -1   -1   -1   -1   -1   -1   -1   -1   -1   -1   -1 
  -1   -1  479   -1  273  274   39   40   41  273  274   -1  479   -1   -1 
  -1   -1  514   -1   -1   -1   74   75   76   -1   -1   -1  514   -1   -1 
  -1   -1   -1   -1   -1   -1  109  110  111   -1   -1   -1   -1   -1   -1 
  -1  407   -1   -1   -1   -1   -1   -1   -1  341   -1   -1  535  164   -1 
  -1  123  124  125   -1   -1   -1   -1   -1   -1   -1   -1   -1  199   -1 
  -1  193  194  195  248   -1   -1   -1   -1   -1  248   -1   -1  234   -1 
  11   -1   -1   -1   -1   -1   -1   -1   -1   -1   -1   -1   -1   -1   10 
  46   -1   -1   -1   -1   -1   -1   -1   -1   -1   -1   -1   -1   -1   45 
  -1   -1   -1   -1   -1   -1   -1   -1   -1   -1   -1   -1   -1   -1   -1 
  -1   -1   -1   -1  248   -1   -1   -1   -1   -1  248   -1   -1   -1   -1 
  -1   -1   -1   -1   -1   -1   -1   -1   -1   -1   -1   -1   -1   -1   -1 
  -1   -1   -1   -1   -1   -1   -1   -1   -1   -1   -1   -1   -1   -1   -1 
  10   -1   -1   -1   -1   -1   -1   -1   -1   -1   -1   -1   -1   -1   11 
  45   -1   -1   -1  248   -1   -1   -1   -1   -1  248   -1   -1   -1   46 
  -1   -1   -1   -1   -1   -1   -1   -1   -1   -1   -1   -1   -1   -1   -1 
  -1   -1   -1   -1   -1   -1   -1   -1   -1   -1   -1   -1   -1   -1   -1 
  -1   -1   -1   -1   -1   -1   -1   -1   -1   -1   -1   -1   -1   -1   -1 
  -1   -1   -1   -1   -1   -1   -1   -1   -1   -1   -1   -1   -1   -1   -1 
  -1   -1   -1   -1   -1   -1   -1   -1   -1   -1   -1   -1   -1   -1   -1 