 526  526  526  526  526  526  526  526  526  526  526  526  526  526  526 
 144  145  145  145  145  145   -1   -1   -1  145  145  145  145  145  146 
 179  180  180  180  180  180   -1   -1   -1  180  180  180  180  180  181 
 214  215  215  215  215  215  224  224  224  215  215  215  215  215  216 
 224  224  224  224  224  224  224  224  224  224  224  224  224  224  224 
 114  224  224  224  224  224  224  224  224  224  224  224  224  224  256 
 146  224  224  224  120  121  121  121  121  121  122  224  224  224  144 
 181  224  224  224  155  156  156  156  156  156  157  224  224  224  179 
 181  224  224  224  190  191  191  191  191  191  192  224  224  224  179 
 181  224  224  224  224  224  224  224  224  224  224  224  224  224  179 
 224  224  224  224  224  224  120  121  122  480  481  482  224  224  224 
 456  456  456  456  456  456  456  456  456  456  456  456  456  456  456 