{
  "largeur": 15,
  "hauteur": 12,
  "chipset": "PalaisRolandInt.png",
  "musique": "Castle_3.mp3",
  "couche0": [
    [ 526,  526,  526,  526,  526,  526,  526,  526,  526,  526,  526,  526,  526,  526,  526],
    [ 144,  145,  145,  145,  145,  145,   -1,   -1,   -1,  145,  145,  145,  145,  145,  146],
    [ 179,  180,  180,  180,  180,  180,   -1,   -1,   -1,  180,  180,  180,  180,  180,  181],
    [ 214,  215,  215,  215,  215,  215,  224,  224,  224,  215,  215,  215,  215,  215,  216],
    [ 224,  224,  224,  224,  224,  224,  224,  224,  224,  224,  224,  224,  224,  224,  224],
    [ 114,  224,  224,  224,  224,  224,  224,  224,  224,  224,  224,  224,  224,  224,  256],
    [ 146,  224,  224,  224,  120,  121,  121,  121,  121,  121,  122,  224,  224,  224,  144],
    [ 181,  224,  224,  224,  155,  156,  156,  156,  156,  156,  157,  224,  224,  224,  179],
    [ 181,  224,  224,  224,  190,  191,  191,  191,  191,  191,  192,  224,  224,  224,  179],
    [ 181,  224,  224,  224,  224,  224,  224,  224,  224,  224,  224,  224,  224,  224,  179],
    [ 224,  224,  224,  224,  224,  224,  120,  121,  122,  480,  481,  482,  224,  224,  224],
    [ 456,  456,  456,  456,  456,  456,  456,  456,  456,  456,  456,  456,  456,  456,  456]
  ],
  "couche1": [
    [  -1,   -1,   -1,   -1,   -1,   -1,   -1,   -1,   -1,   -1,   -1,   -1,   -1,   -1,   -1],
    [ 479,  261,  469,  469,  469,  262,   -1,   -1,   -1,  261,  469,  469,  469,  262,  479],
    [ 514,  296,  504,  504,  504,  297,   -1,   -1,   -1,  296,  504,  504,  504,  297,  514],
    [  11,  331,  539,  539,  539,  332,  329,   -1,  330,  331,  539,  539,  539,  332,   10],
    [  46,   -1,   -1,   -1,   -1,   -1,   -1,   -1,   -1,   -1,   -1,   -1,   -1,   -1,   45],
    [  -1,   -1,   -1,   -1,   -1,   -1,   -1,   -1,   -1,   -1,   -1,   -1,   -1,   -1,   -1],
    [ 479,   -1,   -1,   -1,   -1,   -1,   -1,   -1,   -1,   -1,   -1,   -1,   -1,   -1,  479],
    [ 514,   -1,   -1,   -1,   -1,   -1,   -1,   -1,   -1,   -1,   -1,   -1,   -1,   -1,  514],
    [  -1,   -1,   -1,   -1,   -1,   -1,   -1,   -1,   -1,   -1,   -1,   -1,   -1,   -1,   -1],
    [  10,   -1,   -1,   -1,   -1,   -1,   -1,   -1,   -1,   -1,   -1,   -1,   -1,   -1,   11],
    [  45,   -1,   -1,   -1,  377,  378,   -1,   -1,   -1,   -1,  447,   62,   -1,   -1,   46],
    [  -1,   -1,   -1,   -1,   -1,   -1,   -1,   -1,   -1,   -1,   -1,   -1,   -1,   -1,   -1]
  ],
  "couche2": [
    [  -1,   -1,   -1,   -1,   -1,   -1,   -1,   -1,   -1,   -1,   -1,   -1,   -1,   -1,   -1],
    [  -1,   -1,   -1,   -1,   -1,   -1,  259,   20,  260,   -1,   -1,   -1,   -1,   -1,   -1],
    [  -1,   -1,   -1,   -1,   -1,   -1,  294,   -1,  295,   -1,   -1,   -1,   -1,   -1,   -1],
    [  -1,   -1,   -1,   -1,   -1,   -1,   -1,   -1,   -1,   -1,   -1,   -1,   -1,   -1,   -1],
    [  -1,   -1,   -1,   -1,   -1,   -1,   -1,   -1,   -1,   -1,   -1,   -1,   -1,   -1,   -1],
    [  -1,   -1,   -1,   -1,   -1,   -1,   -1,   -1,   -1,   -1,   -1,   -1,   -1,   -1,   -1],
    [  -1,   28,   -1,   -1,   -1,   -1,   -1,   -1,   -1,   -1,   -1,   -1,   -1,   29,   -1],
    [  -1,   63,   -1,   -1,   -1,   -1,   -1,   -1,   -1,   -1,   -1,   -1,   -1,   64,   -1],
    [  -1,   -1,   -1,   -1,   -1,   -1,   -1,   -1,   -1,   -1,   -1,   -1,   -1,   -1,   -1],
    [  -1,   -1,   -1,   -1,   -1,   -1,   -1,   -1,   -1,   -1,   -1,   -1,   -1,   -1,   -1],
    [  -1,   -1,   -1,   -1,   -1,   -1,   -1,   -1,   -1,   -1,   -1,   -1,   -1,   -1,   -1],
    [  -1,   -1,   -1,   -1,   -1,   -1,   -1,   -1,   -1,   -1,   -1,   -1,   -1,   -1,   -1]
  ]
}