{
  "largeur": 19,
  "hauteur": 23,
  "chipset": "PalaisRolandNouveau.png",
  "musique": "2000_ordeal.mp3",
  "couche0": [
    [  -1,   -1,   -1,   -1,   -1,   55,  100,  100,  100,  100,  100,  100,  100,   54,   -1,   -1,   -1,   -1,   -1],
    [  -1,   -1,   -1,   -1,   -1,   53,  144,  145,  145,  145,  145,  145,  146,   51,   -1,   -1,   -1,   -1,   -1],
    [  -1,   -1,   -1,   -1,   -1,   53,  192,  193,  193,  193,  193,  193,  194,   51,   -1,   -1,   -1,   -1,   -1],
    [  -1,   -1,   -1,   -1,   -1,   53,  192,  193,  193,  193,  193,  193,  194,   51,   -1,   -1,   -1,   -1,   -1],
    [  -1,   -1,   -1,   -1,   -1,   53,  240,  241,  241,  241,  241,  241,  242,   51,   -1,   -1,   -1,   -1,   -1],
    [  -1,   55,  100,  100,  100,  101,    0,    1,    1,    1,    1,    1,    2,   99,  100,  100,  100,   54,   -1],
    [  -1,   53,  144,  145,  145,  146,   48,   49,   49,   49,   49,   49,   50,  144,  145,  145,  146,   51,   -1],
    [  -1,   53,  192,  193,  193,  194,   96,   97,   97,   97,   97,   97,   98,  192,  193,  193,  194,   51,   -1],
    [  -1,   53,  192,  193,  193,  194,  488,  489,  489,  489,  489,  489,  490,  192,  193,  193,  194,   51,   -1],
    [  55,  101,  240,  241,  241,  242,    0,    1,    1,    1,    1,    1,    2,  240,  241,  241,  242,   99,   54],
    [  53,  146,  733,  733,  733,  733,   48,   49,   49,   49,   49,   49,   50,  733,  733,  733,  733,  144,   51],
    [  53,  194,  733,  733,  733,  733,   48,   49,   49,   49,   49,   49,   50,  733,  733,  733,  733,  192,   51],
    [  53,  242,  733,  733,  733,  733,   48,   49,   49,   49,   49,   49,   50,  733,  733,  733,  733,  240,   51],
    [  53,  733,  733,  733,  733,  733,   48,   49,   49,   49,   49,   49,   50,  733,  733,  733,  733,  733,   51],
    [  53,  733,  733,  733,  733,  733,   48,   49,   49,   49,   49,   49,   50,  733,  733,  733,  733,  733,   51],
    [  53,  733,  733,  733,  733,  733,   48,   49,   49,   49,   49,   49,   50,  733,  733,  733,  733,  733,   51],
    [  53,  733,  733,  733,  733,  733,   48,   49,   49,   49,   49,   49,   50,  733,  733,  733,  733,  733,   51],
    [  53,  733,  733,  733,  733,  733,   48,   49,   49,   49,   49,   49,   50,  733,  733,  733,  733,  733,   51],
    [   7,    4,    5,  733,  733,  733,   96,   97,   49,   49,   49,   97,   98,  733,  733,  733,    3,    4,    6],
    [  -1,   -1,    7,    4,    4,    4,    4,    5,   48,   49,   50,    3,    4,    4,    4,    4,    6,   -1,   -1],
    [  -1,   -1,   -1,   -1,   -1,   -1,   -1,   53,   48,   49,   50,   51,   -1,   -1,   -1,   -1,   -1,   -1,   -1],
    [  -1,   -1,   -1,   -1,   -1,   -1,   -1,   53,   96,   97,   98,   51,   -1,   -1,   -1,   -1,   -1,   -1,   -1],
    [  -1,   -1,   -1,   -1,   -1,   -1,   -1,    7,    4,    4,    4,    6,   -1,   -1,   -1,   -1,   -1,   -1,   -1]
  ],
  "couche1": [
    [  -1,   -1,   -1,   -1,   -1,   -1,   -1,   -1,   -1,   -1,   -1,   -1,   -1,   -1,   -1,   -1,   -1,   -1,   -1],
    [  -1,   -1,   -1,   -1,   -1,   -1,  334,  568,  569,  570,  571,  572,  334,   -1,   -1,   -1,   -1,   -1,   -1],
    [  -1,   -1,   -1,   -1,   -1,   -1,  382,  616,  617,  618,  619,  620,  382,   -1,   -1,   -1,   -1,   -1,   -1],
    [  -1,   -1,   -1,   -1,   -1,   -1,  514,  664,  665,  666,  667,  668,  515,   -1,   -1,   -1,   -1,   -1,   -1],
    [  -1,   -1,   -1,   -1,   -1,   -1,  562,  712,  713,  714,  715,  716,  563,   -1,   -1,   -1,   -1,   -1,   -1],
    [  -1,   -1,   -1,   -1,   -1,   -1,   -1,  314,  315,  316,   -1,  191,   -1,   -1,   -1,   -1,   -1,   -1,   -1],
    [  -1,   -1,  573,  574,  575,  334,   -1,  362,  363,  364,   -1,  239,   -1,  334,  573,  574,  575,   -1,   -1],
    [  -1,   -1,  621,  622,  623,  382,   -1,   -1,   -1,   -1,   -1,   -1,   -1,  382,  621,  622,  623,   -1,   -1],
    [  -1,   -1,  669,  670,  671,   -1,   -1,   -1,   -1,   -1,   -1,   -1,   -1,   -1,  669,  670,  671,   -1,   -1],
    [  -1,   -1,  717,  718,  719,   -1,   -1,   -1,   -1,   -1,   -1,   -1,   -1,   -1,  717,  718,  719,   -1,   -1],
    [  -1,   -1,  325,   -1,   -1,  131,   -1,   -1,   -1,   -1,   -1,   -1,   -1,  131,   -1,   -1,  325,   -1,   -1],
    [  -1,  512,   -1,   -1,   -1,   -1,   -1,   -1,   -1,   -1,   -1,   -1,   -1,   -1,   -1,   -1,   -1,  513,   -1],
    [  -1,  560,   -1,   -1,   -1,   -1,   -1,   -1,   -1,   -1,   -1,   -1,   -1,   -1,   -1,   -1,   -1,  561,   -1],
    [  -1,   -1,   -1,   -1,   -1,   -1,   -1,   -1,   43,   44,   45,   -1,   -1,   -1,   -1,   -1,   -1,   -1,   -1],
    [  -1,  231,   -1,   -1,   -1,  753,   -1,   -1,   91,   92,   93,   -1,   -1,  754,   -1,   -1,   -1,  230,   -1],
    [  -1,  279,   -1,   -1,   -1,   -1,   -1,   -1,  139,  140,  141,   -1,   -1,   -1,   -1,   -1,   -1,  278,   -1],
    [  -1,  327,   -1,   -1,   -1,   -1,   -1,   -1,   -1,   -1,   -1,   -1,   -1,   -1,   -1,   -1,   -1,  326,   -1],
    [  -1,   -1,   -1,   -1,   -1,  383,   -1,   -1,   -1,   -1,   -1,   -1,   -1,  383,   -1,   -1,   -1,   -1,   -1],
    [  -1,   -1,   -1,   -1,   -1,   -1,   -1,   -1,   -1,   -1,   -1,   -1,   -1,   -1,   -1,   -1,   -1,   -1,   -1],
    [  -1,   -1,   -1,   -1,   -1,   -1,   -1,   -1,   -1,   -1,   -1,   -1,   -1,   -1,   -1,   -1,   -1,   -1,   -1],
    [  -1,   -1,   -1,   -1,   -1,   -1,   -1,   -1,   -1,   -1,   -1,   -1,   -1,   -1,   -1,   -1,   -1,   -1,   -1],
    [  -1,   -1,   -1,   -1,   -1,   -1,   -1,   -1,   -1,   -1,   -1,   -1,   -1,   -1,   -1,   -1,   -1,   -1,   -1],
    [  -1,   -1,   -1,   -1,   -1,   -1,   -1,   -1,   -1,   -1,   -1,   -1,   -1,   -1,   -1,   -1,   -1,   -1,   -1]
  ],
  "couche2": [
    [  -1,   -1,   -1,   -1,   -1,   -1,   -1,   -1,   -1,   -1,   -1,   -1,   -1,   -1,   -1,   -1,   -1,   -1,   -1],
    [  -1,   -1,   -1,   -1,   -1,   -1,   -1,   -1,   -1,   -1,   -1,   -1,   -1,   -1,   -1,   -1,   -1,   -1,   -1],
    [  -1,   -1,   -1,   -1,   -1,   -1,   -1,   -1,   -1,   -1,   -1,   -1,   -1,   -1,   -1,   -1,   -1,   -1,   -1],
    [  -1,   -1,   -1,   -1,   -1,   -1,   -1,   -1,   -1,   -1,   -1,   -1,   -1,   -1,   -1,   -1,   -1,   -1,   -1],
    [  -1,   -1,   -1,   -1,   -1,   -1,   -1,   -1,   -1,   -1,   -1,   -1,   -1,   -1,   -1,   -1,   -1,   -1,   -1],
    [  -1,   -1,   -1,   -1,   -1,   -1,   -1,   -1,   -1,   -1,   -1,   -1,   -1,   -1,   -1,   -1,   -1,   -1,   -1],
    [  -1,   -1,   -1,   -1,   -1,   -1,   -1,   -1,   -1,   -1,   -1,   -1,   -1,   -1,   -1,   -1,   -1,   -1,   -1],
    [  -1,   -1,   -1,   -1,   -1,   -1,   -1,   -1,   -1,   -1,   -1,   -1,   -1,   -1,   -1,   -1,   -1,   -1,   -1],
    [  -1,   -1,   -1,   -1,   -1,   -1,   -1,   -1,   -1,   -1,   -1,   -1,   -1,   -1,   -1,   -1,   -1,   -1,   -1],
    [  -1,   -1,  277,   -1,   -1,   -1,   -1,   -1,   -1,   -1,   -1,   -1,   -1,   -1,   -1,   -1,  277,   -1,   -1],
    [  -1,   -1,   -1,   -1,   -1,   -1,   -1,   -1,   -1,   -1,   -1,   -1,   -1,   -1,   -1,   -1,   -1,   -1,   -1],
    [  -1,   -1,   -1,   -1,   -1,   -1,   -1,   -1,   -1,   -1,   -1,   -1,   -1,   -1,   -1,   -1,   -1,   -1,   -1],
    [  -1,   -1,   -1,   -1,   -1,   -1,   -1,   -1,   -1,   -1,   -1,   -1,   -1,   -1,   -1,   -1,   -1,   -1,   -1],
    [  -1,   -1,   -1,   -1,   -1,  705,   -1,   -1,   -1,   -1,   -1,   -1,   -1,  706,   -1,   -1,   -1,   -1,   -1],
    [  -1,   -1,   -1,   -1,   -1,   -1,   -1,   -1,   -1,   -1,   -1,   -1,   -1,   -1,   -1,   -1,   -1,   -1,   -1],
    [  -1,   -1,   -1,   -1,   -1,   -1,   -1,   -1,   -1,   -1,   -1,   -1,   -1,   -1,   -1,   -1,   -1,   -1,   -1],
    [  -1,   -1,   -1,   -1,   -1,  335,   -1,   -1,   -1,   -1,   -1,   -1,   -1,  335,   -1,   -1,   -1,   -1,   -1],
    [  -1,   -1,   -1,   -1,   -1,   -1,   -1,   -1,   -1,   -1,   -1,   -1,   -1,   -1,   -1,   -1,   -1,   -1,   -1],
    [  -1,   -1,   -1,   -1,   -1,   -1,   -1,   -1,   -1,   -1,   -1,   -1,   -1,   -1,   -1,   -1,   -1,   -1,   -1],
    [  -1,   -1,   -1,   -1,   -1,   -1,   -1,   -1,   -1,   -1,   -1,   -1,   -1,   -1,   -1,   -1,   -1,   -1,   -1],
    [  -1,   -1,   -1,   -1,   -1,   -1,   -1,   -1,   -1,   -1,   -1,   -1,   -1,   -1,   -1,   -1,   -1,   -1,   -1],
    [  -1,   -1,   -1,   -1,   -1,   -1,   -1,   -1,   -1,   -1,   -1,   -1,   -1,   -1,   -1,   -1,   -1,   -1,   -1],
    [  -1,   -1,   -1,   -1,   -1,   -1,   -1,   -1,   -1,   -1,   -1,   -1,   -1,   -1,   -1,   -1,   -1,   -1,   -1]
  ]
}