 617  617  617  617  617  617  617  617  617  617  617  617  617  617  617  617  617  617  617  617  617  617  617  100  101 
 661  661  113  113  113  113  113  113  113  113  113  113  113  113  113  113  113  113  113  113  113  113  113  100  101 
 182  441  113  113  113  113  113  212  213  217  218  212  213  217  218  219  113  113  113  113  113  113  113  100  101 
 441  528  212  213  217  218  219  212  213  217  217  218  217  217  218  219  212  213  212  213  217  218  219  100  101 
 573  573  212  213  217  218  219  628  629  629  629  629  629  629  629  630  212  213  217  217  217  218  219  100  101 
 617  661  628  629  629  629  630  628  629  629  629   -1  629  629  629  630  628  630  630  630  630  630  630  144   37 
 618  182  628  629  629  629  630  672  673  673  673   -1  673  673  673  674  628  630  630  630  630  630  630  191  144 
 617  573  672  673  673  673  674  126  126  126  126  126  126  126  126  126  672  674  674  674  674  674  674  235  191 
  81   82   82   82   82   82   82   82   82   82  126  126  126   82   82   82   82   82   82   82   82   82   83  188  235 
 125   81  126  126  126  126  126  126  126  126  126  126  126  126  126  126  126  126  126  126  126  126  126   83  188 
 169   81  170  170  170  170  170  170  170  170  126  126  126  170  170  170  170  170  170  170  170  170  170  171   38 
 661  617  617  617  661  617  617  617  617  617  125  126  127  617  617  617  661  617  617  661  661  661  661  617   37 
 182  616  617  618  182  616  617  617  617  617  125  126  127  617  617  618  182  616  618  442  442  442  442  660   38 
 573  617  617  617  573  617  617  617  617  617  169  170  171  617  617  617  573  617  662  182  442  442   18   19  661 
 617  617  617  617  617  617  661  617  617  617   81   82   83  617  617  661  661  662   10  358   10   10   62   63   10 
 660  661  661  661  617  618  182  616   83  617  125  126  127  617  618  442  182   10  238   10   10   10   10   10   10 
 485  485  485  485  616  617  573  617  127  617  125  126  127  617  617  573  574   10  282   10  326   10  239  240  241 
 485  360  485  485  616  617  125  126  127  617  169  170  127  617  617  617  618   10  182   10  360   10  182   10  238 
 485  485  485  485  616  617  169  170  171  617  617  617  617  617  617  617  618   10  242  243   10   10   10   10  282 
 485  485  485  572  617  617  617  617  617  617  125  126   37  617   37  617  618   10  286  287   10   10   10   10   10 
 573  573  573  617  661  617  617   37  617  617   81  126  127  617  617  617  618   10   10   10  233  617  617  617  617 
 617   37  617  618  182  616  617  617  617  617  125   83  127  617  617  617  233  617  617  185  617  617  661  661  661 
 617  617  617  617  573  617  617  617  617  617  125  126   83  617  100  101  617  617  617  617  617  618  441  182  441 
 617  617  617  617  617  617  617  617  617  617  169  170  171  617  144  145  617  146   80  144  145  277  573  573  573 
 617  617  617  617  617  617  617  617  617  617   81   82  127  617  191  192  192  193  124  191  192  144  145  277  617 
 617  617  617  617  617  617  617  617  617  617  125  126  127  617  235  236  236  237   80  235  236  191  192  144  145 
 617  617  617  617  617  617  617  617  617  617  169  126  171  617  188  189  189  190  617  188  189  235  236  191  192 
 617  617  617  617  617  617  617  617  617  617   38  169  171  617  617  617  617  617  617  617  617  188  189  235  236 
 617  212  213  214  216  216  216  217  218  219   83   37   38  617  617  617  617  617  617  617  617  617  617  188  189 
 617  212  213  214  216  216  216  217  218  219  125   83   38  617  617  617  617  617  626  626  626  626  617  661  661 
 617  628  629  629  629  629  629  629  629  630  125  126   83  617   37  617  617  617  626  626  617  626  485  485  485 
 617  628  629  629  629  629  629  629  629  630  125  126  127  617  617  617  617  617  617  617  617  485  399  400  400 
 617  672  673  673  673  673  673  673  673  674  125  126  127  617  617  617  617  617  661  617  618  485  443  444  444 
 617  617  617  617  617  661  661  617  617  617  125  126  127  617  617  617  617  618  182  616  618  182  487  488  488 
 617  617  444  444  401  529  529  616  617  617  125  126  127  617  617  617  617  617  573  617  617  573  573  574  485 
  37  617  444  444  445  529  529  616  617  617  169  126  127  617  617  617  617  617   81   82   82   83  617  617  573 
 617  617  444  444  489  182  529  616  617  617  101  169  171  617  617   81   82   82  126  126  126  127  617  617  617 
 617  617  617  617  617  574  529  660  617  617  185  101  101   37  617  169  126  126  126  126  126  127  617  617  617 
 617  617  617  617  101  618  529  529  660  101  101   37  101  101  101  101  169  170  170  170  170  171  101  617  617 
 617  101  101  101  101  618  529  182  529  616  101  101  101  101  101  101  101  101  101  101  101  101  101  101  617 