 334  334    7  334    6  334  334  334  334  334  334  334  334  334  334  334  334   83   84   48  370  334  334  334  334  334  334  334  334  334  334  334  334  334  334  334  334  334  334  334  371  371  371 
 334  334  334  334  334  334  334  334  334  334  334  334  334  334  334  334  334   83   84   85  333  334  335  334  334  334  334   43   44   45  334  334  334  334  194  194  194  194  194  194  371    6  371 
  43   44   45    7  334  334  334  334  334  334  334  334  384  385  334  334  334   83   84   85  370  371  372  444  334  334  334   80   81   82  334  334  334  334  231  231  231  231  231  231  371  371    9 
  80   81   81   45  334  458  458  458  458  334  334  334  334  334  334  334  334   83   84   85  407  408  409  334  334  334  334  117  118  119  334  334  302  334  231  231  231  231  231  231  371    6    6 
  80   81   81   81   45  494  169  495  495  334  459  457  458  459  459  334   46   84   84   85  371  371   46   48   10  334  334  334  334  334  334  334  334  334  231  231  231  231  231  231  371  371  371 
  80   81   81   81   82  531  206   91  532  334  496  494  495  496  496  334   83   84   84   85  371  371  120  121   47   47   48  334  334  334  334  334  334  334  231  231  231  231  231  231  371  371  371 
 117  118  118   81  119  334  410  411  412  334  533   91  532  533  533   46   84   84   84  122  334  334  334  334  120   84   84   48  334  334  334  334    6  334  231  231  231  231  231  231  371    6  371 
 334  117  118  119  334  334  334  334  334  334  120  121  122  334  334   83   84   84  122  334  334  302  334  334  334  334  120  121  371  371  334  334  334  334  231  231  231  231  231  231  371  371  302 
 334    7  334  370  334  334  334  334  334  334  334  334  334  334   46   84  122  296  334  296  296  334  334  334  444  334  334  334  371  371  371  334  334  334  268  268  268  268  268  268  371    9  371 
 334  334  334  334  334  334    6  371  371  334  302  334  296  296  296  296  296  296  296  296  296  334  334  334  334  334  302  334  334  371  371  371  334  334  334  334  334  334  334  334  371  371    6 
  48  334  334  302  334  334  334   46   48  334  334  334  135  136   56   57   58   62  334   62  137    6  334  334  334  334  334  334  334  154   46   48  334  334  334  334  334  334  334  334  302  371  371 
  85  334  334  334  334  334  334   83   85  334  334   46  172  173  574  575  576   62  334  334  174  334  334  334  334  334  334  334  334  334   83   85  334  334  334  334    6  334  334  339  371  371    9 
 122  334    6  334  334  334  334   83   85  223  223  223  458  458  166  167  168  458  458  458  458  334  302  334  334  135  334   62  334  334  120   84   48  334  334  334  334  334  339  377  371    6  371 
 334  334  334  334  334  334  334  120  122  223  223  223  495  495  203  204  205  495  495  495  495  334  334  154  334  172  334  334  334  334  334   83   85  334  334  334  334  334  376  377  371  371  371 
 334  334  334  296  296  296  334  334  334  223  223  223  495  495  240  241  242  495  495  495  495  334  154  334  334  458  458  458  458  334  334   83   85  334  334  385  423  334  413  414  371    6  371 
 334  334  574  574  575  576  576  334  334  334  334  334  532  532  277  278  279  532  532   91  532  334  334  334  334  494  495  495  495  334   46   84   85  334  334  334  423  334  334  334  371  371  371 
 334  334  574  574  575  576  576  444  334  334  371  371  371  371  371  371  371  371  410  411  412  371  371  334  371  531  532   91  532  334   83   84  122  166  421  422  423  334    6    6  371  371  371 
 334  334  574  166  167  168  576  334  334  334  371  371  371   46   47   48  371  371  371  371  371  371  371  334    6  334  410  411  412  334  120  122  336  457  458  459  460  334  334  334    9  302  371 
   6  334  166  203  204  205  168  338  371  371  302  371   46   84   84  122  371  371  371  371  302  371  371  334  334  334  334  334  334  154  371  371  410  494  495  496  495  334  334  334  371    6  371 
 334  334  203  458  204  458  205  375  371  371  371  371  120  121  122  371  444  371  371  302  371  154   46   47   47   47   47   47   47   47   47   47   47  531  532  533  533  334  334  334  371  371  371 
 334  334  494  240  241  242  494  412   46   48  371  334  334  334  334  334  334  334  334  334  154  334   83  313  238  238  238  238  238  238  238  238  238  238  238   84   84   48  334  334    6  371  302 
 334  334  531  277  278  279  531  371  120  122  334  296  296  296  296  296  296  296  296  296  296  334   83  202  222  222  222  275  275  275  275  275  222  222  222  200   84  201   48  334    6  371  371 
 334  302  334  334  334  334  334  371  371  334  334   98   99  100  172  173  174   98   99   99  100  334   83  202  223  223  223  528  528  528  528  528  223  223  223  200   84  201   85  334  371    6  371 
 334  334  334  334  302  334  371  371  371  334  334  172  173  174  458  458  458  173  173  173  174  334   83  202  223  528  528  528  528  528  528  528  528  528  223  200  201  201   85  334  302  371  371 
 334  334    6  334  334  334  371   46   48  334  334  458  458  458  494  494  494  458  458  458  458    6   83  202  223  528  528  528  528  528  528  528  528  528  223  200  201  201   85  334  371    9  371 
 334   13  334  334  334  334  371   83   85  371  334  494  495  494  531  531  531  494  494  495  494  334   83  202  223  457  458  459  528  528  528  457  458  459  223  200  201  201   85  334  371    6  371 
 334  334    6  334  334  334  371  120  122  371  334  531   91  531  371  371  371  531  531   91  531  334   83  202  223  494  495  496  528  528  528  494  495  496  223  200  201  201   85  334    6  371  371 
 334    9  334  334  334  334   62  371  371  371  302  410  411  412  371  371  371  334  410  411  412  371   83  202  223  531  532  533   54   -1   54  531  532  533  223  200  201  201   85  334  371  302  371 
 334  334  334  334  334  334  334  334  371  371  371  334  334   46   48  371  371   46   48  371  371  154   83  202  223  223  223   54   -1   -1   -1   54  223  223  223  200   84   84   85  302  371  371  371 
 334  334   62  167  168  334  334  334   43   45  371  371  371  120   84   48  371  120  122  371  371  371   83  202  223  223  223  223   -1   -1   -1  223  223  223  223  200   84   84   85  334  371  371  371 
   6  334  203  204  458  458  458  458  117  119  371  371  444  371  120   84   48  334  302  334  334  334  120  311   84  201  201  201   84   84   84   84   84   84   84   84   84   84   85  334  371  371  371 
 334  458  458  458  494  170  495  495  371  371  371  371  371  371  371  120  122  334  334  334  296  334  334  120   84   84   84   84   84   84   84   84   84   84   84   84   84   84  122  334  371  334  334 
 334  494  169  495  531  207  532  532  371  371   43   44   45  371  444  371  371  334  334  574  166  167  168  334  120  121  121  121  121  121  121  121  121  121  121  121  121  122  450  334  371   46   47 
   9  531  532  532  334  410  411  412  371  334  117  118  119  371  371   46   48  334  336  166  203  204  205  168  334  334  334  334  334  334  334  334  334  334  334  334  334  334  334  371  371   83   84 
 371  334  334  334  371  371   46   48  371  334  371  371   46   47   47   84   85  334  410  203  458  204  458  205    6  334  334  334  302  334  334  334  334  334  334  154  453  334  334  371  371   83   84 
 334  334    6  334  334  334  120   84   48  371  371  371  120  121  121   84   85  371  334  494  240  241  242  494  334  334  334  334  334  334  154  334  334  302  334  334  334  334  334  371  371  120  121 
   6  334  339  340  341  334  334  120  121  371  334  334  302  334  371  120  122  371  334  531  277  278  279  531  334  334  334  334   43   44   45  334  334  371  302  334  154  450  334  334  334  334   84 
 334  371  376  377  378  334  334  334  334  334  334  334  334  334  371  371  371  371  334  334  334  334  302  334  334  334    6  334   80   81   82  334  334  334  334  334  334  334  334  334    6  371  371 
 334  371  413  414  415  334  334    6  334  334  334  334  334  334  154  371  371  371  334  334  334  334  334  334  334  334  334  334  117  118  119  334    6  334  334  334  334    6  334  334  371  371    9 
 334  371  371  371  334  334  334  334  334  334  334  334  334  334  334   46   47   48  334  154  334  334  334  334  334  334  334  334  334  334  334  334  334  334  334  302  334  334  334  334    6  302  371 