  -1   -1   -1   -1   -1   -1   -1   -1   -1   -1   -1   -1   -1   -1   -1   -1   -1   -1   -1   -1 
  -1   -1   -1   -1   -1   -1   -1   -1   -1   -1   -1   -1   -1   -1   -1   -1   -1   -1   -1   -1 
  -1   -1   -1   -1   -1   -1   -1   -1   -1   -1   -1   -1   -1   -1   -1   -1   -1   -1   -1   -1 
  -1   -1   -1   -1   -1   -1   -1   -1   -1   -1   -1   -1   -1   -1   -1   -1   -1   -1   -1   -1 
  -1   -1   -1   -1   -1   -1   -1   -1   -1   -1   -1   -1   -1   -1   -1   -1   -1   -1   -1   -1 
  39   18    8    0    0    0    0  303  304  305    0    6   18   13   13  132   13   13   72   73 
  36   12    8    0    0    0    0  303  304  305    0   36  132   12   13   42   43   44  102  103 
  66   36   38    0    0    0    0  303  304  305    0   66   36   39   42   73   14  104   18   13 
  96   66   68  420    0    0    0  303  304  305  406   96   66   36   37   37   37   37   13   13 
 126   96   98  420    0    0    0  303  304  305  436  126   96   66   67   67   67   67   36   39 
 466  126  128  420    0    0    0  303  304  305  466  392  126   96   97   97   97   97   66    6 
 380  466  390  468    0    0    0  333  272  330  275  466  392  126  127  127  127  127   96    6 
 380  380  380  380  380  380    0    0  333  272  330  275  466  391  391  391  391  392  126    6 
 380  380  380  380  380  380  380    0    0  333  272  330  274  274  332  304  305  466  391    6 
 291  380  289  291  380  380  380  380    0    0  333  272  304  304  304  270  335    0    0    6 
 321  380  349  351  380  289  290  291  380    0    0  333  334  334  334  335    0    0    0    6 
 321  380  380  380  380  349  350  351  380  380    0    0    0    0    0    0    0    0    0    6 
 351  380  380  380  380  380  380  380  380  380    0    0    0    0    0    0    0    0    0    6 