  -1   -1   -1   -1   -1   -1   -1   -1   -1   -1   -1   -1  325  326  327  328  329   -1   -1   -1 
  -1   -1  325  326  327  328  329   -1   -1   -1   -1   -1  355  356  357  358  359   -1   -1   -1 
  -1   -1  355  356  357  358  359   -1   -1   -1   -1   -1  385  386  387  388  389   -1   -1   -1 
  -1   -1  385  386  387  388  389   -1   -1   -1   -1   -1  415  416  417  418  419   -1   -1   -1 
  -1   -1  415  416  417  418  419   -1   -1   -1   -1   -1   -1  446  447  448   -1   -1   -1   -1 
  -1   -1   -1  446  447  448   -1   -1   -1   -1   -1   -1   -1   -1   -1   -1   -1   -1   -1   -1 
  -1   -1   -1   -1   -1   -1   -1   -1   -1   -1   -1   -1   -1   -1   -1   -1   -1   -1   -1   -1 
  -1   -1   -1  400  401  401  402   -1   -1   -1   -1   -1   -1   -1   25   26   27   -1   -1   -1 
  -1   -1   -1   -1   -1   -1   -1   -1   -1   -1   -1   -1   -1   54   55   56   57   58   -1   -1 
  -1   -1   -1   -1   -1   -1   -1   -1   -1   -1   -1   -1   -1   84   85   86   87   88   -1   -1 
  -1   -1   -1   -1   -1   -1   -1   -1   -1   -1   -1   -1   -1  114  115  116  117  118   -1   -1 
  -1   -1   -1   -1   -1   -1   -1   -1   -1   -1   -1   -1   -1  144  145  146  147  148   -1   -1 
  -1   -1   -1   -1   -1   -1   -1   -1   -1   -1   -1   -1   -1   -1   -1   -1   -1   -1   -1   -1 
  -1   -1   -1   -1   -1   -1   -1   -1   -1   -1   -1   -1   -1   -1   -1   -1   -1   -1   -1   -1 
  -1   -1   -1   -1   -1   -1   -1   -1   -1   -1   -1   -1   -1   -1   -1   -1   -1   -1   -1   -1 
  -1   -1   -1   -1   -1   -1   -1   -1   -1   -1   -1   -1   -1   -1   -1   -1   -1  237  238   -1 
  -1   -1   -1   -1   -1   -1   -1   -1   -1   -1   -1   -1   -1   -1   -1   -1   -1   -1   -1   -1 
  -1   -1   -1   -1   -1   -1   -1   -1   -1   -1   -1   -1   -1   -1   -1   -1   -1   -1   -1   -1 