  -1   -1   -1  508  509  509  509  509  509  509  509  509  509  510  510   -1   -1   -1   -1   -1   -1   -1   -1   -1   -1   -1   -1   -1   -1   -1   -1   -1   -1   -1  508  509  509  508  509  510   12   13   14 
  -1   -1   -1  545   -1  135  424   62   63   -1   -1   -1   -1   -1  547   -1   -1   -1   -1   -1   -1   -1   -1   -1   -1   -1   -1   -1   -1   -1   -1   -1   -1   -1  472   -1   -1   -1   -1   -1   12   -1   14 
  -1   -1   -1  582  583  172  173  173  174   -1   -1  574   77   78  547   -1   -1   -1   -1   -1   -1   -1   -1   -1   -1   -1   -1   -1   -1   -1   -1   -1   -1   -1   -1   -1   -1   -1   -1   -1   12   -1   14 
  -1   -1   -1   -1   -1   -1   -1   -1   -1   -1  574  420  421  422  576   -1   -1   -1   -1   -1   -1   -1   -1   -1   -1   -1   -1   -1   -1   -1   -1   -1   -1   -1   -1   -1   -1   -1   -1   -1   12   -1   14 
  -1   -1   -1   -1   -1   29   -1  227   -1   -1  456  457   -1   -1  460   -1   -1   -1   -1   -1   -1   -1   -1   -1   -1   -1   -1   -1   -1   -1   -1   -1   -1   -1  545   -1   -1   -1   -1   -1   12   -1   14 
  -1   -1   -1   -1   -1   66   -1  264   -1  319   -1  227   -1   27   28   -1   -1   -1   -1   -1   -1   -1   -1   -1   -1   -1   -1   -1   -1   -1   -1   -1   -1   -1  545   -1   -1   -1   -1  504   12   -1   14 
  -1   -1   -1   -1   -1  503   -1   -1   -1   -1   -1  264  317   64   65   -1   -1   -1   -1   -1   -1   -1   -1   -1   -1   -1   -1   -1   -1   -1   -1   -1   -1   -1  545   -1   -1   -1   -1  541   12   -1   14 
  -1   -1   -1   -1   -1   -1   -1   -1   -1   -1   -1   -1   -1   -1   -1   -1   -1   -1   -1   -1   -1   -1   -1   -1   -1   -1   -1   -1   -1   -1   -1   -1   -1   -1  545   -1   -1   -1   -1  578   12   -1   14 
  -1   -1   -1   -1   -1   -1   -1   -1   -1   -1   -1   -1   -1   -1   -1   -1   -1   -1   -1   -1   -1   -1   -1   -1   -1   -1   -1   -1   -1   -1   -1   -1   -1   -1  582  583  584  582  583  584   12   -1   14 
  -1  212  213  214   -1   -1   -1   -1   -1   -1   -1   -1   -1   -1   -1   -1   -1   -1   -1   -1   -1   -1   -1  398  399   -1   -1   -1   -1   -1   -1   -1   -1   -1   -1   40   41   42   -1   -1   12   -1   14 
  -1   -1   -1   -1   -1   -1   -1   -1   -1   -1   -1   -1   79   -1   93   94   95   77  135  112   -1   -1   -1  435  436   -1   -1   -1   -1   -1   -1   -1   -1   -1   -1   -1   -1   -1  505  506   -1   -1   14 
  -1   -1   -1   -1   -1   -1   -1   -1   -1  508  509  510   -1   -1  130  131  132  173  172  173   -1   -1   -1   -1   -1   -1   -1   -1   -1   -1   -1   -1   -1   -1   -1   -1   -1  505   15   -1   -1   -1   14 
  -1   -1   -1   -1   -1   -1   -1   -1   -1  472   -1   -1   -1   -1   -1   -1   -1  104   -1   -1   -1   -1   -1   -1   -1   74  424   37  137   -1   -1   -1   -1   -1   -1   -1   -1   12   -1   -1   -1   -1   14 
  -1   -1   -1   -1   -1   -1   -1   -1   -1  472   -1   -1   -1   -1   -1   -1   -1  141   -1   -1   -1   -1   73   -1   -1   -1  173  173  174   -1   -1   -1   -1  574  575  576   -1   12   -1   -1   -1   -1   14 
  -1   -1   -1   -1   -1   -1   -1   -1   -1  582  583  584   -1   -1   -1   -1   -1  178   -1  227  356   -1   -1   -1   -1   -1  324   -1   -1   -1   -1   -1   -1  574  575  112   -1   12   -1   -1   -1   -1   14 
  -1   -1  574  574  361   78  576   -1   -1   -1   38   39   -1   -1   -1   -1   -1   -1  326  264  393   -1   -1   -1   -1   -1  361  227   -1   35   -1   -1   -1  574  575  576   -1   49   52   -1   -1   -1   14 
  -1   -1  574  111  575  576  576   -1   -1   -1   -1   -1  286  287  288   -1   -1   -1  363   -1   -1   -1   -1   -1   -1   -1   -1  264   -1   72   -1   -1   -1   -1  107   -1   -1   86   12   -1   -1   -1   14 
  -1   -1  574   -1   -1   -1  576   -1   -1   -1   -1   -1   -1   -1   -1   -1   -1   -1   -1   -1   -1   -1   -1   -1   67   68   69   -1   -1   -1   -1   -1   -1   -1  144   -1  460  123   49   52   -1   -1   14 
  -1   -1   -1   -1   -1   -1   -1   -1   -1   -1   -1   -1   -1   -1   -1   -1   -1   -1   -1   -1   -1   -1   -1   -1   -1   -1   -1   -1   -1   -1   -1   -1   -1   -1  181   -1   -1  160   86   12   -1   -1   14 
  -1   -1   -1   -1   -1  105  106   -1   -1   -1   -1   -1   -1   -1   -1   -1   -1   -1   -1   -1   -1   -1   -1   -1   -1   -1   -1   -1   -1   -1   -1   -1   -1   -1   -1   -1   -1   -1  123   12   -1   -1   14 
  -1   -1   -1   -1   -1  142  143   -1   -1   -1   -1   -1   -1   -1   -1   -1   -1   -1   -1   -1   -1   -1   -1   -1   -1   -1   -1   -1   -1   -1   -1   -1   -1   -1   -1   -1   -1   -1  160   12   -1   -1   14 
  -1   -1   -1   -1   -1  179  180   -1   -1   -1   -1   -1   -1   -1   -1   -1   -1   -1   -1   -1   -1   -1   -1   -1   -1   -1   -1   18   19  538   21   22   -1   -1   -1   -1   84   85  371   12   -1   -1   14 
  -1   -1   -1   -1   -1   -1   -1   -1   -1   -1   -1   -1   -1   -1   -1   -1   -1   -1   -1   -1   -1   -1   -1   -1   -1   24   25   55   56   57   58   59   25   26   -1   -1   84   85  371   12   -1   -1   14 
  -1  468  469  470  471   -1   -1   -1   -1   -1   -1   -1   -1   -1  458  458  458  172   -1   -1  174   -1   -1   -1   -1   61   62   92  346  347  348   96   62   63   -1   -1   84  122  371   12   -1   -1   14 
  -1   -1   -1   -1   -1   -1   -1   -1   -1   -1  318  425  281  426  531  532  533   -1  425  243  426   -1   -1   -1   -1  172  174  129  130  384  132  133  173  174   -1   -1   85   43   44   12   -1   -1   14 
  -1   -1   -1   -1   -1   -1   -1   -1   -1   -1  319  425  227  426  222  222  222   -1  425  227  463   -1   -1   -1   -1  457  458  456  457  458  459  460   -1   -1   -1   -1   85   80   81   12   -1   -1   14 
  -1   -1   -1   -1   -1   -1   -1   -1   -1   -1   -1  531  264  533  223  223  223   -1  462  264  463   73   -1   -1   -1  494  495  457  494  495  496  459   -1   -1   -1   -1   85  117  118   12   -1   -1   14 
  -1   -1   -1   -1   61   61   37   63   -1   -1   -1   -1   -1   -1   -1   -1   -1   -1   -1   -1   -1   -1   -1   -1   -1  259  260  494  531   -1  533  496  260  261   -1   -1   -1   48  334   12   -1   -1   14 
  -1   98   99  100   98   99  100  100   -1   -1   -1   -1   -1   -1   -1   -1   -1   -1   -1   -1   -1   -1   -1   -1   -1   -1   -1  259   54   54   54  261   -1   -1   -1   -1   -1   -1   48   49   50   50   51 
  -1   61   76   62  172  173  173  174   -1   -1   -1   -1   -1   -1   -1   -1   -1   -1   -1   -1   -1   -1   -1   -1   -1   -1   -1   -1   91   91   91   -1   -1   -1   -1   -1   -1   -1   -1   86   87   87   88 
  -1  172  173  174   -1   -1   -1  324   -1   -1   -1   -1   -1   -1   -1   -1   -1   -1   -1   -1   -1   -1   -1   -1  580  580  580  580  128  128  128  580  580  580  580   -1   -1   -1   -1  123  124  124  125 
  -1   -1   -1   -1   -1   -1  497  361   -1   -1   -1   -1   -1   -1   -1   -1   -1   -1   -1  150  150  150  150  150   -1   -1   -1   -1   -1   -1   -1   -1   -1   -1   -1   -1   -1   -1   -1  160  161  161  162 
  -1   28   29   -1   -1   -1  498   -1   -1   -1   -1   -1   -1   -1   -1   -1   -1   -1   -1    0   -1   -1   -1  576   -1   -1   -1   -1   -1   -1   -1   -1   -1   -1   -1   -1   -1   -1   -1   -1   -1   -1   -1 
  -1   65   66   -1  316   -1   -1   -1   -1   -1   -1   -1   -1   -1   -1   -1   -1   -1   -1   -1   -1  324   -1   -1   -1   -1   -1   -1   -1   -1   -1   -1   -1   -1   -1   -1   -1   -1   -1   -1   -1   -1   -1 
  -1  112   -1   -1   -1   -1   -1   -1   -1   -1   -1   -1   -1   -1   -1   -1   -1   -1   -1   -1   -1  361   -1   -1   -1   -1   -1   -1   -1   -1   -1   -1   -1   -1   -1   -1   -1   -1   -1   -1   -1   -1   -1 
  -1   -1   -1   -1   -1  286  287  288   -1   -1   -1   -1   -1   -1   -1   -1   -1   -1   -1   -1   27   28   29   -1   -1   -1   -1   -1   -1   -1   -1   -1   -1   -1   -1   -1   -1   -1   27   -1   -1   -1   -1 
  -1   -1   -1   -1   -1   -1   -1   -1   -1   -1   -1   -1   -1   -1   -1   -1   -1   -1   -1   -1   64   65   66   -1   -1   -1   -1   -1   -1   -1   -1   -1  212  213  214   -1   -1   -1   64   -1  505  506  507 
  -1   -1   -1   -1   -1   -1   -1   -1  212  213  214   -1   -1   -1  316   -1   -1   -1   -1   40   41   42   -1   -1   -1   -1   -1   -1   -1   -1   -1   -1   -1   -1   -1   -1   -1   -1   -1  505   -1   -1   14 
  -1   -1   -1   -1   -1   -1   -1   -1   -1   -1   -1   -1   -1   -1   -1   -1   -1   -1   -1   -1   -1   -1   -1   -1   -1   -1   -1   -1   -1   -1   -1   -1   -1   -1   -1  505  506  506  506   13   -1   -1   14 
  -1   -1   -1   -1   -1   -1   -1   -1   -1   -1   -1   -1   -1   -1   -1   -1   -1   -1   -1   -1   -1   -1   -1   -1   -1   -1   -1   -1   -1   -1   -1   -1   -1   -1  505   -1  468  469  470  471   -1   -1   14 