 376   -1   -1   -1   -1   -1   -1  611  612  611  612  611  612  611  611  612   -1   -1   -1   -1   -1   -1   -1   -1   -1 
 420  244  608  609  610  611  612  655  656  655  656  655  656  655  655  656  611  612  611  612  613  614  615   -1   -1 
 464  288  652  653  654  655  656  699  700  699  700  699  700  699  699  700  655  656  655  656  657  658  659   -1   -1 
  -1   -1  696  697  698  699  700  128  129  130   40   41   42  128  129  130  699  700  699  700  701  702  703   -1  376 
  -1   -1  503   -1  504   -1  505   71   72   73   68   69   70   71   72   73  505   -1   -1   -1  506   -1   -1   -1  420 
 336  337  547  453  548   -1  549  115  116  117  112  113  114  115  116  117  549   -1  364   -1  550  336  337   -1  464 
 380  381  547  497  548   -1  549  159  160  161  156  157  158  159  160  161  549   -1  408   -1  550  380  381   -1   -1 
 424  425  591   -1  592   -1  593  203  204  205  200  201  202  203  204  205  593   -1  636   -1  594  424  425   -1   -1 
  -1   -1  345   -1  345   -1  345   -1   -1   -1   -1   -1   -1  247  248  249  345   -1  345   -1  345   -1   -1   -1   -1 
  -1   -1   -1   -1   -1   -1   -1   -1   -1   -1   -1   -1   -1  291  292  293   -1   -1   -1   -1   -1   -1   -1   -1   -1 
  -1   -1   -1   -1   -1   -1   -1   -1   -1   -1   -1   -1   -1   -1   -1   -1   -1   -1   -1   -1   -1   -1   -1   -1   -1 
  -1  423   -1   -1   -1  600  601  332  464   -1   -1   -1   -1   -1   -1  684  685  686  687   -1   -1   -1   -1   -1   -1 
 333  334  335   -1   -1   -1  333  334  335   -1   -1   -1   -1  333  334  335   -1   -1   -1   -1  330   -1   -1   -1   -1 
 377  378  379  465  466  467  377  378  379   -1   -1   -1   -1  377  378  379  465  466  467   -1   -1   -1   -1   -1   -1 
  -1   -1   -1   -1   -1   -1   -1   -1   -1   -1   -1   -1   -1   -1   -1   -1   -1   -1   -1   -1   -1   -1   -1   -1  593 
  -1  247  248  249   -1   -1  333  334  332   -1   -1   -1   -1   -1   -1   -1   -1   -1   -1   -1   -1   -1   -1   -1  110 
  -1  291  292  293   -1   -1  245  246  376   -1   -1   -1   -1  376   -1   -1   -1   -1   -1   -1   -1   -1   -1   -1   -1 
  -1   -1   -1   -1   -1   -1  289  290  420   -1   -1   -1   -1  420   -1   -1   -1   -1   -1   -1   -1   -1   -1   -1   -1 
  -1   -1  688  689   -1   -1   -1   -1  464   -1   -1   -1   -1  464   -1   -1   -1   -1   -1   -1   -1   -1   -1   -1   -1 
  -1  679   -1   -1  465  466  467   -1   -1   -1   -1   -1   -1   -1   -1   -1   -1   -1   -1   -1  458  459  459  459  459 
  -1   -1   -1   -1   -1   -1   -1   -1   -1   -1   -1   -1   -1   -1   -1   -1  458  459  459  459  684  685  686  687   -1 
  -1   -1   -1   -1   -1   -1   -1   -1  373  375   -1   -1   -1   -1  458  459  600  601   -1   -1   -1   -1   -1   -1  376 
  -1   -1   -1   -1   -1   -1   -1   -1  417  346  375   -1   -1   -1   -1   -1   -1   -1   -1   -1   -1   -1   -1   -1  420 
  -1   -1   -1   -1   -1   -1   -1   -1  461  462  462   -1   -1   -1   -1   -1   -1   -1   -1   -1   -1   -1   -1   -1  464 
  -1  520  521  522  523  523  524  525  526  527   -1   -1   -1   -1   -1   -1   -1   -1   -1   -1   -1   -1   -1   -1   -1 
  -1  520  521  522  523  523  524  525  526  527   -1   -1   -1   -1   -1   -1   -1   -1   -1   -1   -1   -1   -1   -1   -1 
  -1  564  565  566  567  567  568  569  570  571   -1   -1   -1   -1   -1   -1   -1   -1   -1   -1   -1   -1   -1   -1   -1 
  -1  652  653  654  655  655  656  657  658  659   -1   -1   -1  247  248  249   -1   -1   -1   -1   -1   -1   -1   -1   -1 
  -1  696  697  698  699  699  700  699  702  703   -1   -1   -1  291  292  293   -1  373  374  374  374  375   -1   -1   -1 
  -1   -1   -1   -1   -1  128  129  130   -1   -1   -1   -1   -1   -1   -1   -1   -1  417  245  246   -1  346  375   -1   -1 
  -1   -1   -1   -1   -1  172   72  174   -1  634   -1   -1   -1   -1   -1   -1   -1  417  289  290  418   -1  419   -1   -1 
  -1   -1   -1   -1   -1  115  116  117   -1  546   -1   -1   -1   -1   -1   -1  680  461  462  462  462  462  462   -1   -1 
  -1   -1   -1   -1   -1  159  160  161   -1  546   -1   -1   -1  376   -1   -1   -1   -1   -1   -1   -1  600  601   -1   -1 
  -1  373  374  374  375  203  204  205  678  590   -1   -1   -1  420  465  466  467   -1   -1   -1   -1   -1   -1  681   -1 
  -1  417  258  259  463   -1   -1   -1   -1  345   -1   -1   -1  464  688  689  333  334  335   -1   -1   -1   -1   -1   -1 
  -1  417  302  684  685  686  687   -1  376   -1   -1   -1   -1   -1   -1  377  378  379   -1   -1   -1   -1   -1   -1   -1 
  -1  417  346  374  375  681   -1  465  466  467   -1   -1   -1   -1   -1   -1   -1   -1   -1  332  333  334  335   -1   -1 
  -1  461  260  418  419   -1   -1   -1   -1   -1   -1   -1   -1   -1   -1   -1   -1   -1  680  376   -1  332   -1   -1   -1 
  -1   -1  461  462  463   -1   -1   -1   -1   -1   -1   -1   -1   -1   -1   -1   -1   -1   -1  420   -1   -1   -1   -1   -1 
  -1   -1   -1   -1   -1   -1   -1   -1   -1   -1   -1   -1   -1   -1   -1   -1   -1   -1   -1  464  465  466  467   -1   -1 