 240  240  240  240  240  240  240  240  240  240  240  240  240  240  240  240  303  304  304  304  304  304  304  305  240  240  240  240  240  240  240  240  240  240  240  240  240  240  240  240 
 240  240  240  240  240  240  240  240  240  240  240  240  240  240  240  240  333  394  394  394  394  394  394  305  240  240  240  240  240  240  240  240  240  240  240  240  240  240  240  240 
 240  240  240  240  240  240  240  240  240  240  240  240  240  240  240  240  240  333  394  394  394  394  394  305  240  240  240  240  240    4  240  240  240  240  240  240  240  240  240  240 
 240  240  240  240  240  240  240  240  240    4  240  406  451  451  451  451  451  408  333  394  394  394  394  305  240  240  240  240  240  240  240  240  240  240  240  240  240  240  240  240 
 240  240  240  240  240  240  240  240  240  406  451  452   13   13   13   13   13  450  408  303  394  394  394  330  275  240  240  406  451  451  451  451  408  240  240  240  240  240  240  240 
 240  240  240  240  240  240  240  240  240  422   13   42   43   44   13   12   13  374  420  303  394  394  394  394  330  275  406  452  168  169  169  170  450  408  240  240  240    4  240  240 
 240  240  240  240  240  240  240  240  406  452   42   73   73   73   43   44   13  390  468  303  394  394  394  394  270  335  422  168  199  199  199  199  170  420  240  240  240  240  240  240 
 240  240  240  240  240  240  240  240  422   13  102   73   73   73   73  104  390  468  273  332  394  270  334  334  335  406  452  228  199  199  199  199  199  450  408  240  240  240  240  240 
 240  240    4  240  240  406  452  451  452   13   13  102  103  103  104  390  468  273  332  394  394  305  406  451  451  452    7   18  228  229  229  199  199  170  450  408  240  240  240  240 
 240  240  240  240  240  422   13   48   50   13   13   13   13   13   13  420  273  394  394  394  394  305  422    7   42   43   44   13    7    7    7  228  199  199  170  450  451  408  240  240 
 240  240  240  240  240  422   48   79   79   50   13   13   13   13   13  420  303  394  394  394  394  305  422   42   73   73  104    7   12    7    7    7  198  199  199  169  170  450  408  240 
 240  240  240  240  240  392  108  109   79   79   50   13   13   12   13  420  333  334  334  394  394  305  422  102  103  104    7   15    7    7    7    7  198  199  199  199  199  170  420  240 
 240  240  240  240  240  466  392   13  108   79   79   50   13   13   13  450  451  451  408  303  394  305  466  391  391  392    7   12    7    7  139  139  228  229  229  199  199  230  420  240 
 240  240  240  240  240  240  422   13   18  108  109  110   13   13   13   13   13   13  438  303  394  394  275  421  421  422   19   19   19   48   49   50   19   19   19  228  230  390  468  240 
 240  240  240  240  240  240  422   13   13   13  138   13   13   13   13   12   13   13  438  303  394  394  394  275  421  422   19   19   48   79   79   80   19   12   19   19  390  468  240  240 
 240  240  240  240  240  240  422   18   13   13   13   13  138   13   13  390  467  467  468  273  394  394  394  305  421  422   19   48   79   79  109  110   19   19   19  390  468  240  240  240 
 240  240  240  240  240  406  452  168  169  169  169  170  139  390  467  468  240  240  273  394  394  394  394  305  421  466  392  108  109  110   19   12   19   19  390  468  240  240  240  240 
 240  240  406  451  451  452  168  199  199  199  199  200  390  468  240  240  240  240  303  394  394  394  394  305  421  421  466  391  391  391  391  391  391  391  468  240  240  240  240  240 
 240  406  452  168  169  169  199  199  199  199  229  230  438  240  240  273  274  274  332  394  394  394  394  330  274  274  275  241  241  241  241  241  241  241  241  240  240  240  240  240 
 240  436  168  199  199  199  199  199  199  200  390  467  468  421  273  332  394  394  394  394  394  394  394  394  394  394  305  241  241  241  241  241  241  241  241  240  240  240  240  240 
 240  436  198  199  199  199  199  199  199  200  438  240  240  273  332  394  394  394  394  394  394  394  394  394  394  394  305  241  241  241  241  241  241  241  241  240  240  240  240  240 
 240  436  228  229  229  199  199  199  199  200  438  240  273  332  394  394  394  394  394  394  394  394  394  394  394  394  305  241  241  241  241  241  241  241  241  240  240  240  240  240 
 240  436   13   13   13  228  229  199  199  200  438  240  303  394  394  394  394  394  394  394  394  394  394  394  394  394  330  275  241  241  241  241  241  241  241  241  240  240  240  240 
 240  466  392   18   13   13   13  198  200   13  438  240  303  394  394  394  394  394  394  394  394  394  394  394  394  394  394  330  275  241  241  241  241  241  241  241  240  240  240  240 
 240  240  436   13   13   18   13  198  200   13  438  240  303  394  394  394  394  394  394  394  394  394  394  394  394  394  394  394  330  275  241  241  241  241  241  240  240  240    4  240 
 240  240  436   13   13   13   13  228  230   13  438  240  303  394  394  394  394  394  394  394  394  394  394  394  394  394  394  394  394  330  274  274  274  274  275  240  240  240  240  240 
 240  240  466  467  467  467  467  467  467  467  468  240  333  334  272  394  394  394  394  394  394  394  394  394  394  394  394  394  394  394  394  394  394  394  305  240  240  240  240  240 
 240  240  240  240  240  273  274  274  274  274  274  275  241  241  303  394  394  394  394  394  394  394  394  394  394  394  394  394  394  394  394  394  394  394  305  240  240  240  240  240 
 240  240  240  240  240  303  304  304  304  304  304  305  241  241  333  334  334  334  334  334  272  394  394  394  394  394  394  394  394  394  394  394  394  394  305  240  240  240  240  240 
 240  240  240  240  240  303  304  304  304  304  304  330  275  241  241  241  241  241  241  241  333  272  394  394  394  394  394  394  394  394  394  394  394  394  305  240  240  240  240  240 
 240  240  240  240  240  303  304  304  304  304  304  304  305  241  241  241  241  241  241  241  241  303  394  394  394  394  394  394  394  394  394  394  394  394  305  240  240  240  240  240 
 240  240  240  240  240  303  304  304  304  304  304  304  305  241  241  241  241  241  241  241  241  303  394  394  394  394  394  394  394  394  394  394  304  304  305  240  240  240  240  240 
 240  240  240  240  240  303  304  304  304  304  304  304  305  241  241  241  241  241  241  241  241  303  394  394  394  394  394  394  394  394  394  304  304  270  335  240  240  240  240  240 
 240  240  240  240  240  303  304  304  304  304  304  304  330  275  241  241  241  241  241  241  241  333  334  334  334  334  334  334  334  334  334  334  334  335  240  240  240  240  240  240 
 240  240  240  240  240  303  304  304  304  304  304  304  304  305  241  241  241  273  274  274  274  274  274  274  274  275  241  241  241  241  241  241  241  421  240  240  240  240  240  240 
 240  240  240  240  240  333  272  304  304  304  304  304  304  305  241  241  273  332  394  394  394  394  394  394  394  330  275  241  241  241  241  241  421  421  240  240  240  240  240  240 
 240  240  240  240  240  240  333  334  334  334  334  334  334  335  241  241  303  394  394  394  394  394  394  394  394  394  330  274  274  274  275  241  421  240  240  240  240  240  240  240 
 240  240  240  240  240  240  240  240  240  240  240  240  240  240  240  240  303  394  394  394  394  394  394  394  394  394  394  394  394  304  305  241  421  240  240  240  240  240  240  240 
 240  240  240  240  240  240  240  240  240  240  240  240  240  240  240  240  303  394  394  394  394  394  394  394  394  394  394  394  394  304  305  421  421  240    4  240  240  240  240  240 
 240  240  240  240  240  240  240  240  240  240  240  240  240  240  240  240  333  272  394  394  394  394  394  394  394  394  394  394  394  270  335  421  421  240  240  240  240  240  240  406 
 240  240  240  240  240  240  240  240  240  240  240  240  240  240  240  240  240  333  334  334  334  334  334  334  334  334  334  334  334  335  240  240  240  240  406  407  407  407  407  452 
 240  240  240    4  240  240  240  240  240  240  240  240  240  240  240  240  240  240  240  240  240  240  240  240  240  240  240  240  240  240  240  240  240  406  452    7    7    7    7    7 
 240  240  240  240  240  240  240  240  240  240  240  240  240  240  240  240  240  240    4  240  240  240  240  240  240  240  240  240  240  240  240  240  406    7    7    7    7    7   18    7 
 240  240  240  240  240  240  240  240  240  240  240  240  240  240  240  240  240  240  240  240  240  240  240  240  240  240  240  240  240  240  240  240  436    7    7   12    7    7    7    7 
 240  240  240  240  240  240  240  240  240  240  240    4  240  240  240  240  240  240  240  240  240  240  240  240  240  240  240  240  240  240  240  240  436    7   12    7    7    7    7    7 
 240  240  240  240  240  240  240  240  240  240  240  240  240  240  240  240  240  240  240  240  240  240  240  240  240  240  240    4  240  240  240  240  436    7    7    7    7    7    7    7 
 240  240  240  240  240  240  240  240  240  240  240  240  240  240  240  240  240  240  240  240  240  406  407  407  407  408  240  240  240  240  240  406  452    7   18    7    7    7   12    7 
 240  240  240  240  240  240  240  240  240  240  240  240  240  240  240  240  240  240  240  240  406  452   12    7    7  450  408  240  240  240  406  452    7    7    7    7    7    7    7    7 
 240  240  240  240  240  240  240  240  240  240  240  240  240  240  240  240  240  240  240  406  452    7    7    7   18    7  450  407  407  407  452    7    7   12    7    7  138    7    7    7 
 240  240  240  240  240  240  240  240  240  240  240  240  240  240  240  240  240  240  240  422   45   46   46   46   46   47    7    7    7    7    7    7    7    7    7    7    7    7   15    7 