{
  "largeur": 25,
  "hauteur": 40,
  "chipset": "chipset173.png",
  "musique": "cc_viper_manor.mp3",
  "couche0": [
    [ 617,  617,  617,  617,  617,  617,  617,  617,  617,  617,  617,  617,  617,  617,  617,  617,  617,  617,  617,  617,  617,  617,  617,  100,  101],
    [ 661,  661,  113,  113,  113,  113,  113,  113,  113,  113,  113,  113,  113,  113,  113,  113,  113,  113,  113,  113,  113,  113,  113,  100,  101],
    [ 182,  441,  113,  113,  113,  113,  113,  212,  213,  217,  218,  212,  213,  217,  218,  219,  113,  113,  113,  113,  113,  113,  113,  100,  101],
    [ 441,  528,  212,  213,  217,  218,  219,  212,  213,  217,  217,  218,  217,  217,  218,  219,  212,  213,  212,  213,  217,  218,  219,  100,  101],
    [ 573,  573,  212,  213,  217,  218,  219,  628,  629,  629,  629,  629,  629,  629,  629,  630,  212,  213,  217,  217,  217,  218,  219,  100,  101],
    [ 617,  661,  628,  629,  629,  629,  630,  628,  629,  629,  629,   -1,  629,  629,  629,  630,  628,  630,  630,  630,  630,  630,  630,  144,   37],
    [ 618,  182,  628,  629,  629,  629,  630,  672,  673,  673,  673,   -1,  673,  673,  673,  674,  628,  630,  630,  630,  630,  630,  630,  191,  144],
    [ 617,  573,  672,  673,  673,  673,  674,  126,  126,  126,  126,  126,  126,  126,  126,  126,  672,  674,  674,  674,  674,  674,  674,  235,  191],
    [  81,   82,   82,   82,   82,   82,   82,   82,   82,   82,  126,  126,  126,   82,   82,   82,   82,   82,   82,   82,   82,   82,   83,  188,  235],
    [ 125,   81,  126,  126,  126,  126,  126,  126,  126,  126,  126,  126,  126,  126,  126,  126,  126,  126,  126,  126,  126,  126,  126,   83,  188],
    [ 169,   81,  170,  170,  170,  170,  170,  170,  170,  170,  126,  126,  126,  170,  170,  170,  170,  170,  170,  170,  170,  170,  170,  171,   38],
    [ 661,  617,  617,  617,  661,  617,  617,  617,  617,  617,  125,  126,  127,  617,  617,  617,  661,  617,  617,  661,  661,  661,  661,  617,   37],
    [ 182,  616,  617,  618,  182,  616,  617,  617,  617,  617,  125,  126,  127,  617,  617,  618,  182,  616,  618,  442,  442,  442,  442,  660,   38],
    [ 573,  617,  617,  617,  573,  617,  617,  617,  617,  617,  169,  170,  171,  617,  617,  617,  573,  617,  662,  182,  442,  442,   18,   19,  661],
    [ 617,  617,  617,  617,  617,  617,  661,  617,  617,  617,   81,   82,   83,  617,  617,  661,  661,  662,   10,  358,   10,   10,   62,   63,   10],
    [ 660,  661,  661,  661,  617,  618,  182,  616,   83,  617,  125,  126,  127,  617,  618,  442,  182,   10,  238,   10,   10,   10,   10,   10,   10],
    [ 485,  485,  485,  485,  616,  617,  573,  617,  127,  617,  125,  126,  127,  617,  617,  573,  574,   10,  282,   10,  326,   10,  239,  240,  241],
    [ 485,  360,  485,  485,  616,  617,  125,  126,  127,  617,  169,  170,  127,  617,  617,  617,  618,   10,  182,   10,  360,   10,  182,   10,  238],
    [ 485,  485,  485,  485,  616,  617,  169,  170,  171,  617,  617,  617,  617,  617,  617,  617,  618,   10,  242,  243,   10,   10,   10,   10,  282],
    [ 485,  485,  485,  572,  617,  617,  617,  617,  617,  617,  125,  126,   37,  617,   37,  617,  618,   10,  286,  287,   10,   10,   10,   10,   10],
    [ 573,  573,  573,  617,  661,  617,  617,   37,  617,  617,   81,  126,  127,  617,  617,  617,  618,   10,   10,   10,  233,  617,  617,  617,  617],
    [ 617,   37,  617,  618,  182,  616,  617,  617,  617,  617,  125,   83,  127,  617,  617,  617,  233,  617,  617,  185,  617,  617,  661,  661,  661],
    [ 617,  617,  617,  617,  573,  617,  617,  617,  617,  617,  125,  126,   83,  617,  100,  101,  617,  617,  617,  617,  617,  618,  441,  182,  441],
    [ 617,  617,  617,  617,  617,  617,  617,  617,  617,  617,  169,  170,  171,  617,  144,  145,  617,  146,   80,  144,  145,  277,  573,  573,  573],
    [ 617,  617,  617,  617,  617,  617,  617,  617,  617,  617,   81,   82,  127,  617,  191,  192,  192,  193,  124,  191,  192,  144,  145,  277,  617],
    [ 617,  617,  617,  617,  617,  617,  617,  617,  617,  617,  125,  126,  127,  617,  235,  236,  236,  237,   80,  235,  236,  191,  192,  144,  145],
    [ 617,  617,  617,  617,  617,  617,  617,  617,  617,  617,  169,  126,  171,  617,  188,  189,  189,  190,  617,  188,  189,  235,  236,  191,  192],
    [ 617,  617,  617,  617,  617,  617,  617,  617,  617,  617,   38,  169,  171,  617,  617,  617,  617,  617,  617,  617,  617,  188,  189,  235,  236],
    [ 617,  212,  213,  214,  216,  216,  216,  217,  218,  219,   83,   37,   38,  617,  617,  617,  617,  617,  617,  617,  617,  617,  617,  188,  189],
    [ 617,  212,  213,  214,  216,  216,  216,  217,  218,  219,  125,   83,   38,  617,  617,  617,  617,  617,  626,  626,  626,  626,  617,  661,  661],
    [ 617,  628,  629,  629,  629,  629,  629,  629,  629,  630,  125,  126,   83,  617,   37,  617,  617,  617,  626,  626,  617,  626,  485,  485,  485],
    [ 617,  628,  629,  629,  629,  629,  629,  629,  629,  630,  125,  126,  127,  617,  617,  617,  617,  617,  617,  617,  617,  485,  399,  400,  400],
    [ 617,  672,  673,  673,  673,  673,  673,  673,  673,  674,  125,  126,  127,  617,  617,  617,  617,  617,  661,  617,  618,  485,  443,  444,  444],
    [ 617,  617,  617,  617,  617,  661,  661,  617,  617,  617,  125,  126,  127,  617,  617,  617,  617,  618,  182,  616,  618,  182,  487,  488,  488],
    [ 617,  617,  444,  444,  401,  529,  529,  616,  617,  617,  125,  126,  127,  617,  617,  617,  617,  617,  573,  617,  617,  573,  573,  574,  485],
    [  37,  617,  444,  444,  445,  529,  529,  616,  617,  617,  169,  126,  127,  617,  617,  617,  617,  617,   81,   82,   82,   83,  617,  617,  573],
    [ 617,  617,  444,  444,  489,  182,  529,  616,  617,  617,  101,  169,  171,  617,  617,   81,   82,   82,  126,  126,  126,  127,  617,  617,  617],
    [ 617,  617,  617,  617,  617,  574,  529,  660,  617,  617,  185,  101,  101,   37,  617,  169,  126,  126,  126,  126,  126,  127,  617,  617,  617],
    [ 617,  617,  617,  617,  101,  618,  529,  529,  660,  101,  101,   37,  101,  101,  101,  101,  169,  170,  170,  170,  170,  171,  101,  617,  617],
    [ 617,  101,  101,  101,  101,  618,  529,  182,  529,  616,  101,  101,  101,  101,  101,  101,  101,  101,  101,  101,  101,  101,  101,  101,  617]
  ],
  "couche1": [
    [ 376,   -1,   -1,   -1,   -1,   -1,   -1,  611,  612,  611,  612,  611,  612,  611,  611,  612,   -1,   -1,   -1,   -1,   -1,   -1,   -1,   -1,   -1],
    [ 420,  244,  608,  609,  610,  611,  612,  655,  656,  655,  656,  655,  656,  655,  655,  656,  611,  612,  611,  612,  613,  614,  615,   -1,   -1],
    [ 464,  288,  652,  653,  654,  655,  656,  699,  700,  699,  700,  699,  700,  699,  699,  700,  655,  656,  655,  656,  657,  658,  659,   -1,   -1],
    [  -1,   -1,  696,  697,  698,  699,  700,  128,  129,  130,   40,   41,   42,  128,  129,  130,  699,  700,  699,  700,  701,  702,  703,   -1,  376],
    [  -1,   -1,  503,   -1,  504,   -1,  505,   71,   72,   73,   68,   69,   70,   71,   72,   73,  505,   -1,   -1,   -1,  506,   -1,   -1,   -1,  420],
    [ 336,  337,  547,  453,  548,   -1,  549,  115,  116,  117,  112,  113,  114,  115,  116,  117,  549,   -1,  364,   -1,  550,  336,  337,   -1,  464],
    [ 380,  381,  547,  497,  548,   -1,  549,  159,  160,  161,  156,  157,  158,  159,  160,  161,  549,   -1,  408,   -1,  550,  380,  381,   -1,   -1],
    [ 424,  425,  591,   -1,  592,   -1,  593,  203,  204,  205,  200,  201,  202,  203,  204,  205,  593,   -1,  636,   -1,  594,  424,  425,   -1,   -1],
    [  -1,   -1,  345,   -1,  345,   -1,  345,   -1,   -1,   -1,   -1,   -1,   -1,  247,  248,  249,  345,   -1,  345,   -1,  345,   -1,   -1,   -1,   -1],
    [  -1,   -1,   -1,   -1,   -1,   -1,   -1,   -1,   -1,   -1,   -1,   -1,   -1,  291,  292,  293,   -1,   -1,   -1,   -1,   -1,   -1,   -1,   -1,   -1],
    [  -1,   -1,   -1,   -1,   -1,   -1,   -1,   -1,   -1,   -1,   -1,   -1,   -1,   -1,   -1,   -1,   -1,   -1,   -1,   -1,   -1,   -1,   -1,   -1,   -1],
    [  -1,  423,   -1,   -1,   -1,  600,  601,  332,  464,   -1,   -1,   -1,   -1,   -1,   -1,  684,  685,  686,  687,   -1,   -1,   -1,   -1,   -1,   -1],
    [ 333,  334,  335,   -1,   -1,   -1,  333,  334,  335,   -1,   -1,   -1,   -1,  333,  334,  335,   -1,   -1,   -1,   -1,  330,   -1,   -1,   -1,   -1],
    [ 377,  378,  379,  465,  466,  467,  377,  378,  379,   -1,   -1,   -1,   -1,  377,  378,  379,  465,  466,  467,   -1,   -1,   -1,   -1,   -1,   -1],
    [  -1,   -1,   -1,   -1,   -1,   -1,   -1,   -1,   -1,   -1,   -1,   -1,   -1,   -1,   -1,   -1,   -1,   -1,   -1,   -1,   -1,   -1,   -1,   -1,  593],
    [  -1,  247,  248,  249,   -1,   -1,  333,  334,  332,   -1,   -1,   -1,   -1,   -1,   -1,   -1,   -1,   -1,   -1,   -1,   -1,   -1,   -1,   -1,  110],
    [  -1,  291,  292,  293,   -1,   -1,  245,  246,  376,   -1,   -1,   -1,   -1,  376,   -1,   -1,   -1,   -1,   -1,   -1,   -1,   -1,   -1,   -1,   -1],
    [  -1,   -1,   -1,   -1,   -1,   -1,  289,  290,  420,   -1,   -1,   -1,   -1,  420,   -1,   -1,   -1,   -1,   -1,   -1,   -1,   -1,   -1,   -1,   -1],
    [  -1,   -1,  688,  689,   -1,   -1,   -1,   -1,  464,   -1,   -1,   -1,   -1,  464,   -1,   -1,   -1,   -1,   -1,   -1,   -1,   -1,   -1,   -1,   -1],
    [  -1,  679,   -1,   -1,  465,  466,  467,   -1,   -1,   -1,   -1,   -1,   -1,   -1,   -1,   -1,   -1,   -1,   -1,   -1,  458,  459,  459,  459,  459],
    [  -1,   -1,   -1,   -1,   -1,   -1,   -1,   -1,   -1,   -1,   -1,   -1,   -1,   -1,   -1,   -1,  458,  459,  459,  459,  684,  685,  686,  687,   -1],
    [  -1,   -1,   -1,   -1,   -1,   -1,   -1,   -1,  373,  375,   -1,   -1,   -1,   -1,  458,  459,  600,  601,   -1,   -1,   -1,   -1,   -1,   -1,  376],
    [  -1,   -1,   -1,   -1,   -1,   -1,   -1,   -1,  417,  346,  375,   -1,   -1,   -1,   -1,   -1,   -1,   -1,   -1,   -1,   -1,   -1,   -1,   -1,  420],
    [  -1,   -1,   -1,   -1,   -1,   -1,   -1,   -1,  461,  462,  462,   -1,   -1,   -1,   -1,   -1,   -1,   -1,   -1,   -1,   -1,   -1,   -1,   -1,  464],
    [  -1,  520,  521,  522,  523,  523,  524,  525,  526,  527,   -1,   -1,   -1,   -1,   -1,   -1,   -1,   -1,   -1,   -1,   -1,   -1,   -1,   -1,   -1],
    [  -1,  520,  521,  522,  523,  523,  524,  525,  526,  527,   -1,   -1,   -1,   -1,   -1,   -1,   -1,   -1,   -1,   -1,   -1,   -1,   -1,   -1,   -1],
    [  -1,  564,  565,  566,  567,  567,  568,  569,  570,  571,   -1,   -1,   -1,   -1,   -1,   -1,   -1,   -1,   -1,   -1,   -1,   -1,   -1,   -1,   -1],
    [  -1,  652,  653,  654,  655,  655,  656,  657,  658,  659,   -1,   -1,   -1,  247,  248,  249,   -1,   -1,   -1,   -1,   -1,   -1,   -1,   -1,   -1],
    [  -1,  696,  697,  698,  699,  699,  700,  699,  702,  703,   -1,   -1,   -1,  291,  292,  293,   -1,  373,  374,  374,  374,  375,   -1,   -1,   -1],
    [  -1,   -1,   -1,   -1,   -1,  128,  129,  130,   -1,   -1,   -1,   -1,   -1,   -1,   -1,   -1,   -1,  417,  245,  246,   -1,  346,  375,   -1,   -1],
    [  -1,   -1,   -1,   -1,   -1,  172,   72,  174,   -1,  634,   -1,   -1,   -1,   -1,   -1,   -1,   -1,  417,  289,  290,  418,   -1,  419,   -1,   -1],
    [  -1,   -1,   -1,   -1,   -1,  115,  116,  117,   -1,  546,   -1,   -1,   -1,   -1,   -1,   -1,  680,  461,  462,  462,  462,  462,  462,   -1,   -1],
    [  -1,   -1,   -1,   -1,   -1,  159,  160,  161,   -1,  546,   -1,   -1,   -1,  376,   -1,   -1,   -1,   -1,   -1,   -1,   -1,  600,  601,   -1,   -1],
    [  -1,  373,  374,  374,  375,  203,  204,  205,  678,  590,   -1,   -1,   -1,  420,  465,  466,  467,   -1,   -1,   -1,   -1,   -1,   -1,  681,   -1],
    [  -1,  417,  258,  259,  463,   -1,   -1,   -1,   -1,  345,   -1,   -1,   -1,  464,  688,  689,  333,  334,  335,   -1,   -1,   -1,   -1,   -1,   -1],
    [  -1,  417,  302,  684,  685,  686,  687,   -1,  376,   -1,   -1,   -1,   -1,   -1,   -1,  377,  378,  379,   -1,   -1,   -1,   -1,   -1,   -1,   -1],
    [  -1,  417,  346,  374,  375,  681,   -1,  465,  466,  467,   -1,   -1,   -1,   -1,   -1,   -1,   -1,   -1,   -1,  332,  333,  334,  335,   -1,   -1],
    [  -1,  461,  260,  418,  419,   -1,   -1,   -1,   -1,   -1,   -1,   -1,   -1,   -1,   -1,   -1,   -1,   -1,  680,  376,   -1,  332,   -1,   -1,   -1],
    [  -1,   -1,  461,  462,  463,   -1,   -1,   -1,   -1,   -1,   -1,   -1,   -1,   -1,   -1,   -1,   -1,   -1,   -1,  420,   -1,   -1,   -1,   -1,   -1],
    [  -1,   -1,   -1,   -1,   -1,   -1,   -1,   -1,   -1,   -1,   -1,   -1,   -1,   -1,   -1,   -1,   -1,   -1,   -1,  464,  465,  466,  467,   -1,   -1]
  ],
  "couche2": [
    [  -1,   -1,   -1,   -1,   -1,   -1,   -1,   -1,   -1,   -1,   -1,   -1,   -1,   -1,   -1,   -1,   -1,   -1,   -1,   -1,   -1,   -1,   -1,   -1,   -1],
    [  -1,   -1,   -1,   -1,   -1,   -1,   -1,   -1,   -1,   -1,   -1,   -1,   -1,   -1,   -1,   -1,   -1,   -1,   -1,   -1,   -1,   -1,   -1,   -1,   -1],
    [  -1,   -1,   -1,   -1,   -1,   -1,   -1,   -1,   -1,   -1,   -1,   -1,   -1,   -1,   -1,   -1,   -1,   -1,   -1,   -1,   -1,   -1,   -1,   -1,   -1],
    [  -1,   -1,   -1,   -1,   -1,   -1,   -1,   -1,   -1,   -1,   -1,   -1,   -1,   -1,   -1,   -1,   -1,   -1,   -1,   -1,   -1,   -1,   -1,   -1,   -1],
    [  -1,   -1,   -1,   -1,   -1,   -1,   -1,   -1,   -1,   -1,   -1,   -1,   -1,   -1,   -1,   -1,   -1,   -1,   -1,   -1,   -1,   -1,   -1,   -1,   -1],
    [  -1,   -1,   -1,   -1,   -1,   -1,   -1,   -1,   -1,   -1,   -1,   -1,   -1,   -1,   -1,   -1,   -1,   -1,   -1,   -1,   -1,   -1,   -1,   -1,   -1],
    [  -1,   -1,   -1,   -1,   -1,   -1,   -1,   -1,   -1,   -1,   -1,   -1,   -1,   -1,   -1,   -1,   -1,   -1,   -1,   -1,   -1,   -1,   -1,   -1,   -1],
    [  -1,   -1,   -1,   -1,   -1,   -1,   -1,   -1,   -1,   -1,   -1,   -1,   -1,   -1,   -1,  508,  509,  510,  511,   -1,   -1,   -1,   -1,   -1,   -1],
    [  -1,   -1,   -1,   -1,   -1,   -1,   -1,   -1,   -1,   -1,   -1,   -1,   -1,   -1,   -1,  552,  553,  554,  555,   -1,   -1,   -1,   -1,   -1,   -1],
    [  -1,   -1,   -1,   -1,   -1,   -1,   -1,   -1,   -1,   -1,   -1,   -1,   -1,   -1,   -1,  596,  597,  598,  599,   -1,   -1,   -1,   -1,   -1,   -1],
    [  -1,   -1,   -1,   -1,   -1,  556,  557,   -1,   -1,   -1,   -1,   -1,   -1,   -1,   -1,  640,  641,  642,  643,   -1,   -1,   -1,   -1,   -1,   -1],
    [  -1,   -1,   -1,   -1,   -1,   -1,   -1,   -1,   -1,   -1,   -1,   -1,   -1,   -1,   -1,   -1,   -1,   -1,   -1,   -1,  244,   -1,   -1,   -1,   -1],
    [  -1,   -1,   -1,  421,  422,   -1,   -1,   -1,   -1,   -1,   -1,   -1,   -1,   -1,   -1,   -1,  421,  422,   -1,   -1,   -1,   -1,   -1,   -1,  637],
    [  -1,   -1,   -1,   -1,   -1,   -1,   -1,   -1,   -1,   -1,   -1,   -1,   -1,   -1,   -1,   -1,   -1,   -1,   -1,   -1,   -1,   -1,   -1,   -1,  549],
    [  -1,   -1,   -1,   -1,   -1,   -1,   -1,   -1,   -1,   -1,   -1,   -1,   -1,   -1,   -1,   -1,   -1,   -1,   -1,   -1,   -1,   -1,   -1,   -1,   -1],
    [  -1,   -1,   -1,   -1,   -1,   -1,   -1,   -1,   -1,   -1,   -1,   -1,   -1,   -1,   -1,   -1,   -1,   -1,   -1,   -1,   -1,   -1,   -1,   -1,   -1],
    [  -1,   -1,   -1,   -1,   -1,   -1,   -1,   -1,   -1,   -1,   -1,   -1,   -1,   -1,   -1,   -1,   -1,   -1,   -1,   -1,  508,  509,  510,  511,   -1],
    [  -1,   -1,  644,  645,   -1,   -1,   -1,   -1,   -1,   -1,   -1,   -1,   -1,   -1,   -1,   -1,   -1,   -1,   -1,   -1,  552,  553,  554,  555,   -1],
    [  -1,   -1,   -1,   -1,  421,  422,   -1,   -1,   -1,   -1,   -1,   -1,   -1,   -1,   -1,   -1,   -1,   -1,   -1,   -1,  596,  597,  598,  599,   -1],
    [  -1,   -1,   -1,   -1,   -1,   -1,   -1,   -1,   -1,   -1,   -1,   -1,   -1,   -1,   -1,   -1,   -1,   -1,   -1,   -1,  640,  641,  642,  643,   -1],
    [  -1,   -1,   -1,   -1,   -1,   -1,   -1,   -1,   -1,   -1,   -1,   -1,   -1,   -1,   -1,   -1,  556,  557,   -1,   -1,   -1,   -1,   -1,   -1,   -1],
    [  -1,   -1,   -1,   -1,   -1,   -1,   -1,   -1,   -1,   -1,   -1,   -1,   -1,   -1,   -1,   -1,   -1,   -1,   -1,   -1,   -1,   -1,   -1,   -1,   -1],
    [  -1,  388,  389,  390,  391,  392,  392,  393,  394,  395,   -1,   -1,   -1,   -1,   -1,   -1,   -1,   -1,   -1,   -1,   -1,   -1,   -1,   -1,   -1],
    [  -1,  432,  433,  434,  435,  436,  436,  437,  438,  439,   -1,   -1,   -1,   -1,   -1,   -1,   -1,   -1,   -1,   -1,   -1,   -1,   -1,   -1,   -1],
    [  -1,   -1,   -1,   -1,   -1,   -1,   -1,   -1,   -1,   -1,   -1,   -1,   -1,   -1,   -1,   -1,   -1,   -1,   -1,   -1,   -1,   -1,   -1,   -1,   -1],
    [  -1,   -1,   -1,   -1,   -1,   -1,   -1,   -1,   -1,   -1,   -1,   -1,   -1,   -1,   -1,   -1,   -1,   -1,   -1,   -1,   -1,   -1,   -1,   -1,   -1],
    [  -1,   -1,   -1,   -1,   -1,   -1,   -1,   -1,   -1,   -1,   -1,   -1,   -1,   -1,   -1,   -1,   -1,   -1,   -1,   -1,   -1,   -1,   -1,   -1,   -1],
    [  -1,   -1,   -1,   -1,   -1,   -1,   -1,   -1,   -1,   -1,   -1,   -1,   -1,   -1,   -1,   -1,   -1,   -1,   -1,   -1,   -1,   -1,   -1,   -1,   -1],
    [  -1,   -1,   -1,   -1,   -1,   -1,   -1,   -1,   -1,   -1,   -1,   -1,   -1,   -1,   -1,   -1,   -1,   -1,   -1,   -1,   -1,   -1,   -1,   -1,   -1],
    [  -1,   -1,   -1,   -1,   -1,   -1,   -1,   -1,   -1,   -1,   -1,   -1,   -1,   -1,   -1,   -1,   -1,   -1,   -1,   -1,   -1,   -1,   -1,   -1,   -1],
    [  -1,   -1,   -1,   -1,   -1,   -1,   -1,   -1,   -1,   -1,   -1,   -1,   -1,   -1,   -1,   -1,   -1,   -1,   -1,   -1,   -1,   -1,   -1,   -1,   -1],
    [  -1,   -1,   -1,  508,  509,  510,  511,   -1,   -1,   -1,   -1,   -1,   -1,   -1,   -1,   -1,   -1,   -1,   -1,   -1,   -1,  556,  557,   -1,   -1],
    [  -1,   -1,   -1,  552,  553,  554,  555,   -1,   -1,   -1,   -1,   -1,   -1,   -1,  421,  422,   -1,   -1,   -1,   -1,   -1,   -1,   -1,   -1,   -1],
    [  -1,   -1,   -1,  596,  597,  598,  599,   -1,   -1,   -1,   -1,   -1,   -1,   -1,  644,  645,   -1,   -1,   -1,   -1,   -1,   -1,   -1,   -1,   -1],
    [  -1,   -1,   -1,  640,  641,  642,  643,   -1,   -1,   -1,   -1,   -1,   -1,   -1,   -1,   -1,   -1,   -1,   -1,   -1,   -1,   -1,   -1,   -1,   -1],
    [  -1,   -1,   -1,   -1,   -1,   -1,   -1,  421,  422,   -1,   -1,   -1,   -1,   -1,   -1,   -1,   -1,   -1,   -1,   -1,   -1,   -1,   -1,   -1,   -1],
    [  -1,   -1,   -1,   -1,   -1,   -1,   -1,   -1,   -1,   -1,   -1,   -1,   -1,   -1,   -1,   -1,   -1,   -1,   -1,   -1,   -1,   -1,   -1,   -1,   -1],
    [  -1,   -1,   -1,   -1,   -1,   -1,   -1,   -1,   -1,   -1,   -1,   -1,   -1,   -1,   -1,   -1,   -1,   -1,   -1,   -1,   -1,   -1,   -1,   -1,   -1],
    [  -1,   -1,   -1,   -1,   -1,   -1,   -1,   -1,   -1,   -1,   -1,   -1,   -1,   -1,   -1,   -1,   -1,   -1,   -1,   -1,  421,  422,   -1,   -1,   -1],
    [  -1,   -1,   -1,   -1,   -1,   -1,   -1,   -1,   -1,   -1,   -1,   -1,   -1,   -1,   -1,   -1,   -1,   -1,   -1,   -1,   -1,   -1,   -1,   -1,   -1]
  ]
}