{
  "largeur": 20,
  "hauteur": 18,
  "chipset": "marais2.png",
  "musique": "cc_viper_manor.mp3",
  "couche0": [
    [  -1,   -1,   -1,   -1,   -1,   -1,   -1,   -1,   -1,   -1,   -1,   -1,   -1,   -1,   -1,   -1,   -1,   -1,   -1,   -1],
    [  -1,   -1,   -1,   -1,   -1,   -1,   -1,   -1,   -1,   -1,   -1,   -1,   -1,   -1,   -1,   -1,   -1,   -1,   -1,   -1],
    [  -1,   -1,   -1,   -1,   -1,   -1,   -1,   -1,   -1,   -1,   -1,   -1,   -1,   -1,   -1,   -1,   -1,   -1,   -1,   -1],
    [  -1,   -1,   -1,   -1,   -1,   -1,   -1,   -1,   -1,   -1,   -1,   -1,   -1,   -1,   -1,   -1,   -1,   -1,   -1,   -1],
    [  -1,   -1,   -1,   -1,   -1,   -1,   -1,   -1,   -1,   -1,   -1,   -1,   -1,   -1,   -1,   -1,   -1,   -1,   -1,   -1],
    [  39,   18,    8,    0,    0,    0,    0,  303,  304,  305,    0,    6,   18,   13,   13,  132,   13,   13,   72,   73],
    [  36,   12,    8,    0,    0,    0,    0,  303,  304,  305,    0,   36,  132,   12,   13,   42,   43,   44,  102,  103],
    [  66,   36,   38,    0,    0,    0,    0,  303,  304,  305,    0,   66,   36,   39,   42,   73,   14,  104,   18,   13],
    [  96,   66,   68,  420,    0,    0,    0,  303,  304,  305,  406,   96,   66,   36,   37,   37,   37,   37,   13,   13],
    [ 126,   96,   98,  420,    0,    0,    0,  303,  304,  305,  436,  126,   96,   66,   67,   67,   67,   67,   36,   39],
    [ 466,  126,  128,  420,    0,    0,    0,  303,  304,  305,  466,  392,  126,   96,   97,   97,   97,   97,   66,    6],
    [ 380,  466,  390,  468,    0,    0,    0,  333,  272,  330,  275,  466,  392,  126,  127,  127,  127,  127,   96,    6],
    [ 380,  380,  380,  380,  380,  380,    0,    0,  333,  272,  330,  275,  466,  391,  391,  391,  391,  392,  126,    6],
    [ 380,  380,  380,  380,  380,  380,  380,    0,    0,  333,  272,  330,  274,  274,  332,  304,  305,  466,  391,    6],
    [ 291,  380,  289,  291,  380,  380,  380,  380,    0,    0,  333,  272,  304,  304,  304,  270,  335,    0,    0,    6],
    [ 321,  380,  349,  351,  380,  289,  290,  291,  380,    0,    0,  333,  334,  334,  334,  335,    0,    0,    0,    6],
    [ 321,  380,  380,  380,  380,  349,  350,  351,  380,  380,    0,    0,    0,    0,    0,    0,    0,    0,    0,    6],
    [ 351,  380,  380,  380,  380,  380,  380,  380,  380,  380,    0,    0,    0,    0,    0,    0,    0,    0,    0,    6]
  ],
  "couche1": [
    [  -1,   -1,   -1,   -1,   -1,   -1,   -1,   -1,   -1,   -1,   -1,   -1,   -1,   -1,   -1,   -1,   -1,   -1,   -1,   -1],
    [  -1,   -1,   -1,   -1,   -1,   -1,   -1,   -1,   -1,   -1,   -1,   -1,   -1,   -1,   -1,   -1,   -1,   -1,   -1,   -1],
    [  -1,   -1,   -1,   -1,   -1,   -1,   -1,   -1,   -1,   -1,   -1,   -1,   -1,   -1,   -1,   -1,   -1,   -1,   -1,   -1],
    [  -1,   -1,   -1,   -1,   -1,   -1,   -1,   -1,   -1,   -1,   -1,   -1,   -1,   -1,   -1,   -1,   -1,   -1,   -1,   -1],
    [  -1,   -1,   -1,   -1,   -1,   -1,   -1,   -1,   -1,   -1,   -1,   -1,   -1,   -1,   -1,   -1,   -1,   -1,   -1,   -1],
    [  -1,   -1,   -1,   -1,   -1,   -1,   -1,   -1,   -1,   -1,   -1,   -1,   -1,  476,  477,  478,   -1,   -1,   -1,   -1],
    [  -1,   -1,   -1,  476,  477,  478,   -1,   -1,   -1,   -1,   -1,   -1,   -1,   -1,   -1,   -1,   -1,   -1,   -1,   -1],
    [  -1,   -1,   -1,   -1,   -1,   -1,   -1,   -1,   -1,   -1,   -1,   -1,   -1,   -1,   -1,   -1,   -1,   -1,   -1,   -1],
    [  -1,   -1,   -1,  430,   -1,   -1,  432,   -1,   -1,   -1,   -1,   -1,   -1,   -1,   -1,   -1,   -1,   -1,   -1,   -1],
    [  -1,   -1,   -1,   -1,  234,  235,  236,   -1,   -1,   -1,   -1,   -1,   -1,   -1,   -1,   -1,   -1,   -1,   -1,   -1],
    [ 414,   -1,   -1,   -1,  264,  265,  266,   -1,   -1,   -1,   -1,   -1,   -1,   -1,   -1,   -1,   -1,   -1,   -1,   -1],
    [  -1,  414,   -1,   -1,  294,  295,  296,   -1,   -1,   -1,   -1,   -1,   -1,   -1,   -1,   -1,   -1,   -1,   -1,   -1],
    [  -1,   -1,   -1,   -1,   -1,   -1,  414,   -1,   -1,   -1,   -1,   -1,   -1,  174,  175,  176,  177,  178,   -1,   -1],
    [  -1,   -1,   -1,   -1,   -1,   -1,   -1,  414,   -1,   -1,   -1,   -1,   -1,  204,  205,  206,  207,  208,   -1,   -1],
    [  -1,   -1,   -1,   -1,   -1,   -1,   -1,   -1,  414,   -1,   -1,   -1,   -1,   -1,   -1,   -1,   -1,   -1,   -1,   -1],
    [  -1,   -1,   -1,   -1,   -1,   -1,   -1,   -1,   -1,  414,   -1,   -1,  234,  235,  236,   -1,   -1,   -1,   -1,   -1],
    [  -1,   -1,   -1,   -1,   -1,   -1,   -1,   -1,   -1,   -1,   -1,   -1,  264,  265,  266,   -1,   -1,  267,  268,   -1],
    [  -1,   -1,   -1,   -1,   -1,   -1,   -1,   -1,   -1,   -1,   -1,   -1,  294,  295,  296,   -1,   -1,   -1,   -1,   -1]
  ],
  "couche2": [
    [  -1,   -1,   -1,   -1,   -1,   -1,   -1,   -1,   -1,   -1,   -1,   -1,  325,  326,  327,  328,  329,   -1,   -1,   -1],
    [  -1,   -1,  325,  326,  327,  328,  329,   -1,   -1,   -1,   -1,   -1,  355,  356,  357,  358,  359,   -1,   -1,   -1],
    [  -1,   -1,  355,  356,  357,  358,  359,   -1,   -1,   -1,   -1,   -1,  385,  386,  387,  388,  389,   -1,   -1,   -1],
    [  -1,   -1,  385,  386,  387,  388,  389,   -1,   -1,   -1,   -1,   -1,  415,  416,  417,  418,  419,   -1,   -1,   -1],
    [  -1,   -1,  415,  416,  417,  418,  419,   -1,   -1,   -1,   -1,   -1,   -1,  446,  447,  448,   -1,   -1,   -1,   -1],
    [  -1,   -1,   -1,  446,  447,  448,   -1,   -1,   -1,   -1,   -1,   -1,   -1,   -1,   -1,   -1,   -1,   -1,   -1,   -1],
    [  -1,   -1,   -1,   -1,   -1,   -1,   -1,   -1,   -1,   -1,   -1,   -1,   -1,   -1,   -1,   -1,   -1,   -1,   -1,   -1],
    [  -1,   -1,   -1,  400,  401,  401,  402,   -1,   -1,   -1,   -1,   -1,   -1,   -1,   25,   26,   27,   -1,   -1,   -1],
    [  -1,   -1,   -1,   -1,   -1,   -1,   -1,   -1,   -1,   -1,   -1,   -1,   -1,   54,   55,   56,   57,   58,   -1,   -1],
    [  -1,   -1,   -1,   -1,   -1,   -1,   -1,   -1,   -1,   -1,   -1,   -1,   -1,   84,   85,   86,   87,   88,   -1,   -1],
    [  -1,   -1,   -1,   -1,   -1,   -1,   -1,   -1,   -1,   -1,   -1,   -1,   -1,  114,  115,  116,  117,  118,   -1,   -1],
    [  -1,   -1,   -1,   -1,   -1,   -1,   -1,   -1,   -1,   -1,   -1,   -1,   -1,  144,  145,  146,  147,  148,   -1,   -1],
    [  -1,   -1,   -1,   -1,   -1,   -1,   -1,   -1,   -1,   -1,   -1,   -1,   -1,   -1,   -1,   -1,   -1,   -1,   -1,   -1],
    [  -1,   -1,   -1,   -1,   -1,   -1,   -1,   -1,   -1,   -1,   -1,   -1,   -1,   -1,   -1,   -1,   -1,   -1,   -1,   -1],
    [  -1,   -1,   -1,   -1,   -1,   -1,   -1,   -1,   -1,   -1,   -1,   -1,   -1,   -1,   -1,   -1,   -1,   -1,   -1,   -1],
    [  -1,   -1,   -1,   -1,   -1,   -1,   -1,   -1,   -1,   -1,   -1,   -1,   -1,   -1,   -1,   -1,   -1,  237,  238,   -1],
    [  -1,   -1,   -1,   -1,   -1,   -1,   -1,   -1,   -1,   -1,   -1,   -1,   -1,   -1,   -1,   -1,   -1,   -1,   -1,   -1],
    [  -1,   -1,   -1,   -1,   -1,   -1,   -1,   -1,   -1,   -1,   -1,   -1,   -1,   -1,   -1,   -1,   -1,   -1,   -1,   -1]
  ]
}