{
  "largeur": 30,
  "hauteur": 40,
  "chipset": "marais2.png",
  "musique": "cc_viper_manor.mp3",
  "couche0": [
    [   7,    7,    7,    7,    7,    7,    7,    7,    7,    8,  240,  240,  240,  240,  303,  304,  305,  240,  240,  240,  240,  240,  240,  240,  240,  240,  240,  240,  240,  240],
    [  18,    7,    7,    7,    7,    7,   40,   37,   37,   38,  240,  240,  240,  240,  303,  304,  305,  240,  240,  240,  240,  240,  240,  240,  240,  240,  240,  240,  240,  240],
    [   7,  138,    7,    7,   40,   37,   38,   67,   67,   68,  240,  240,  240,  240,  303,  304,  305,  240,  240,  240,  240,  240,  240,  240,  240,  240,  240,  240,  240,  240],
    [   7,    7,    7,   40,   38,   67,   68,   97,   97,   98,  408,  240,  240,  240,  303,  304,  305,  240,  240,    4,  240,  240,  406,  407,  407,  407,  407,  408,  240,  240],
    [ 373,   18,   40,   38,   68,   97,   98,  127,  127,  128,  438,  240,  240,  240,  303,  304,  330,  275,  240,  240,  240,  240,  436,   12,  437,  437,  437,  450,  407,  408],
    [  40,   37,   38,   68,   98,  127,  128,  437,  390,  467,  468,  240,  240,  240,  333,  272,  304,  330,  275,  240,  240,  240,  436,  437,  437,  437,   42,   43,   44,  450],
    [   8,   67,   68,   98,  128,   18,  390,  467,  468,  240,  240,  240,  240,  240,  240,  302,  304,  304,  305,  240,  240,  240,  466,  392,  437,   42,   73,   73,   73,   44],
    [  38,   97,   98,  128,  390,  467,  468,  240,  240,  240,  240,  240,  240,  240,  240,  302,  270,  334,  335,    1,  240,  240,  240,  436,  437,  102,   73,   73,  104,  104],
    [  68,  127,  128,  390,  468,  240,  240,  240,    4,  240,  240,  240,  240,  240,  273,  332,  305,  240,  240,  240,  240,  240,  240,  466,  392,  437,  102,  103,  104,  437],
    [  98,  437,  390,  468,  240,  240,  240,  240,  240,  240,  240,  240,  240,  240,  303,  304,  305,  240,  240,  240,  240,  240,  240,  240,  466,  392,  437,  437,  437,  390],
    [ 128,  390,  468,  240,  240,  240,  240,  240,  240,  240,  240,  240,  240,  240,  303,  304,  305,  240,  240,  240,  240,  241,  240,  240,  240,  436,  437,   12,  437,  468],
    [ 467,  468,  240,  240,  240,  240,  240,  240,  240,  240,  240,  273,  274,  274,  332,  304,  330,  275,  240,  240,  240,  241,  240,  240,  240,  466,  467,  467,  468,  240],
    [ 240,  240,  240,  240,  240,  240,  240,  240,  240,  240,  273,  332,  304,  304,  304,  304,  304,  305,  240,  240,  240,  241,  240,  240,  240,  240,  240,  240,  240,  240],
    [ 240,  240,  240,  240,  240,  240,  240,  240,  240,  273,  332,  304,  304,  304,  304,  304,  304,  305,  240,  240,  241,  241,  240,  240,  240,  240,  240,  240,  240,  240],
    [ 240,  240,  240,  240,  240,  240,  240,  240,  240,  303,  304,  304,  304,  304,  304,  304,  270,  335,  240,  240,  241,  240,  240,  240,  240,  240,  240,  240,  240,  240],
    [ 240,  240,  240,  240,  240,  240,  240,  240,  240,  303,  304,  304,  304,  304,  304,  304,  335,  241,  240,  240,    4,  241,  240,  240,  240,  240,  240,  240,  240,  240],
    [ 240,  240,  240,  240,  240,  240,  240,  240,  273,  332,  304,  304,  304,  304,  270,  335,  241,  241,  240,  240,  240,  241,  240,  240,  240,  240,  240,  240,  240,  240],
    [ 240,  240,  240,  240,  240,  240,  240,  240,  302,  304,  304,  304,  304,  304,  305,  301,  301,  301,  240,  240,  241,  241,  240,  240,  240,  240,  240,    4,  240,  240],
    [ 240,  240,  240,  240,  240,  240,  240,  240,  303,  304,  304,  304,  304,  304,  305,  301,  301,  301,  240,  240,  241,  241,  240,  240,  240,  240,  240,  240,  240,  240],
    [ 240,  240,  240,  240,  240,  240,  240,  240,  303,  304,  304,  304,  304,  304,  305,  406,  407,  407,  407,  408,  241,  241,  240,  240,  240,  240,  240,  240,  240,  240],
    [ 240,  240,  240,  240,  240,  240,  273,  331,  332,  304,  304,  304,  304,  304,  305,  452,   18,  437,  437,  450,  408,  240,  240,  240,  240,  240,  240,  240,  240,  240],
    [ 240,  240,  240,  240,  240,  240,  302,  304,  304,  304,  304,  304,  304,  304,  316,   12,  437,  437,  437,  437,  450,  408,  240,  240,  240,  240,  240,  240,  240,  240],
    [ 240,  240,  240,  240,  240,  240,  302,  304,  304,  304,  304,  304,  304,  304,  346,  411,   15,  437,   18,  437,   12,  438,  240,  240,  240,  240,  240,  240,  240,  240],
    [ 240,  240,  240,  240,  240,  240,  302,  304,  304,  304,  304,  304,  304,  304,  304,  346,  347,  347,  347,  347,  411,  438,  240,  240,  240,  240,  240,  240,  240,  240],
    [ 240,  240,  240,    4,  240,  240,  303,  304,  304,  304,  304,  304,  304,  304,  304,  304,  304,  304,  304,  304,  316,  438,  240,  240,  240,  240,  240,  240,  240,  240],
    [ 240,  240,  240,  240,  240,  240,  333,  271,  271,  272,  304,  304,  304,  304,  304,  304,  304,  304,  304,  304,  346,  468,  240,  240,  240,  240,  240,  240,  240,  240],
    [ 240,  240,  240,  240,  240,  240,  240,  240,  240,  303,  304,  304,  304,  304,  304,  304,  304,  304,  304,  304,  330,  331,  331,  275,  240,  240,  240,  240,  240,  240],
    [ 240,  240,  240,  240,  240,  240,  240,  240,  240,  303,  304,  304,  304,  304,  304,  304,  304,  304,  304,  304,  304,  304,  304,  300,  240,  240,  240,  240,  240,  240],
    [   7,  240,  240,  240,  240,  240,  240,  240,  240,  303,  304,  304,  304,  304,  304,  304,  304,  304,  304,  304,  304,  304,  304,  300,  240,  240,  240,  240,  240,  240],
    [   7,    7,    7,    7,  240,  240,  240,  240,  240,  333,  334,  334,  272,  304,  304,  304,  304,  304,  304,  304,  304,  270,  334,  335,  240,  240,  240,  240,  240,  240],
    [   7,    7,    7,    7,    7,  240,  240,  240,  240,  240,  240,  240,  333,  271,  272,  304,  304,  304,  304,  304,  304,  300,  240,  240,  240,  240,  240,  240,  240,  240],
    [  12,    7,   18,    7,    7,  240,  240,  240,  240,  240,  240,  240,  240,  240,  302,  304,  304,  304,  304,  304,  304,  300,  240,  240,  240,    4,  240,  240,  240,    7],
    [   7,    7,    7,    7,   15,  240,  240,  240,  240,  240,  240,  240,  240,  240,  333,  334,  272,  304,  304,  304,  270,  335,  240,  240,  240,  240,  240,  240,  132,    7],
    [   7,    7,    7,    7,    7,  240,  240,  240,  240,  240,  240,  240,  240,  240,  240,  240,  303,  304,  304,  270,  335,  240,  240,  240,  240,  240,  240,  240,    7,    7],
    [  12,    7,    7,    7,    7,    7,  240,  240,  240,  240,    4,  240,  240,  240,  240,  240,  303,  304,  270,  335,  240,  240,  240,  240,  240,  240,  240,  240,    7,    7],
    [   7,    7,   15,    7,    7,    7,    7,  240,  240,  240,  240,  240,  240,  240,  240,  240,  303,  304,  305,  240,  240,  240,  240,  240,  240,  240,  240,  240,    7,   12],
    [  43,   44,    7,    7,    7,    7,    7,    7,  240,  240,  240,  240,  240,  240,  240,  240,  303,  304,  305,  240,  240,  240,  240,  240,  240,  240,  240,   18,    7,    7],
    [  73,   73,   44,    7,    7,    7,   15,    7,  301,  240,  240,  240,  240,  240,  240,  240,  303,  304,  305,  240,  240,  240,    7,    7,   12,    7,    7,   42,   43,   43],
    [  73,   73,   73,   44,    7,    7,    7,   12,    7,  301,  301,  301,  240,  240,  240,  240,  303,  304,  305,  240,  240,    7,  132,    7,    7,   15,   42,   73,   73,   73],
    [  73,   73,   73,   74,   18,    7,    7,    7,   12,    7,  301,  301,  240,  240,  240,  240,  303,  304,  305,  240,  240,   12,    7,    7,   18,   42,   73,   73,   73,   73]
  ],
  "couche1": [
    [  -1,   -1,   -1,   -1,   -1,   -1,   -1,   -1,   -1,   -1,   -1,   -1,   -1,   -1,   -1,   -1,   -1,   -1,   -1,   -1,   -1,   -1,   -1,   -1,   -1,   -1,   -1,   -1,   -1,   -1],
    [  -1,   -1,   -1,   -1,   -1,   -1,   -1,   -1,   -1,   -1,   -1,   -1,   -1,   -1,   -1,   -1,   -1,   -1,   -1,   -1,   -1,   -1,   -1,   -1,   -1,   -1,   -1,   -1,   -1,   -1],
    [  -1,   -1,   -1,   -1,   -1,   -1,   -1,   -1,   -1,   -1,   -1,  234,  235,  236,   -1,   -1,   -1,   -1,   -1,   -1,   -1,   -1,   -1,   -1,   -1,   -1,   -1,   -1,   -1,   -1],
    [  -1,   -1,   -1,   -1,   -1,   -1,   -1,   -1,   -1,   -1,   -1,  264,  265,  266,   -1,   -1,   -1,   -1,   -1,   -1,   -1,   -1,   -1,   -1,   -1,   -1,   -1,   -1,   -1,   -1],
    [  -1,   -1,   -1,   -1,   -1,   -1,   -1,   -1,   -1,   -1,   -1,  294,  295,  296,   -1,   -1,   -1,   -1,   -1,   -1,   -1,   -1,   -1,   -1,   -1,   -1,   -1,   -1,   -1,   -1],
    [  -1,   -1,   -1,   -1,   -1,   -1,   -1,   -1,   -1,   -1,  234,  236,   -1,   -1,   -1,   -1,   -1,   -1,   -1,   -1,   -1,   -1,   -1,   -1,   -1,   -1,   -1,   -1,   -1,   -1],
    [  -1,   -1,   -1,   -1,   -1,   -1,   -1,   -1,   -1,   -1,  294,  296,   -1,   -1,   -1,   -1,   -1,   -1,   -1,   -1,   -1,   -1,   -1,   -1,   -1,   -1,   -1,   -1,   -1,   -1],
    [  -1,   -1,   -1,   -1,   -1,   -1,   -1,   -1,   -1,   -1,   -1,   -1,   -1,   -1,   -1,   -1,   -1,   -1,   -1,   -1,   -1,   -1,   -1,   -1,   -1,   -1,   -1,   -1,   -1,   -1],
    [  -1,   -1,   -1,   -1,   -1,   -1,   -1,   -1,   -1,   -1,   -1,   -1,   -1,   -1,   -1,   -1,   -1,   -1,   -1,   -1,   -1,   -1,   -1,   -1,   -1,   -1,   -1,   -1,   -1,   -1],
    [  -1,   -1,   -1,   -1,   -1,   -1,   -1,   -1,   -1,   -1,   -1,   -1,   -1,   -1,   -1,   -1,   -1,   -1,   -1,  234,  235,  236,   -1,   -1,   -1,   -1,   -1,   -1,   -1,   -1],
    [  -1,   -1,   -1,   -1,   -1,   -1,   -1,   -1,   -1,  234,  236,   -1,   -1,   -1,   -1,   -1,   -1,   -1,   -1,  264,  265,  266,   -1,   -1,   -1,   -1,   -1,   -1,   -1,   -1],
    [  -1,   -1,   -1,   -1,   -1,   -1,   -1,   -1,   -1,  294,  296,   -1,   -1,   -1,   -1,   -1,   -1,   -1,   -1,  294,  295,  296,   -1,   -1,   -1,   -1,   -1,   -1,   -1,   -1],
    [  -1,   -1,   -1,   -1,   -1,   -1,   -1,   -1,   -1,   -1,   -1,   -1,   -1,   -1,   -1,   -1,   -1,   -1,   -1,   -1,   -1,   -1,   -1,   -1,   -1,   -1,   -1,   -1,   -1,   -1],
    [  -1,   -1,   -1,   -1,   -1,   -1,   -1,   -1,   -1,   -1,   -1,   -1,   -1,   -1,   -1,   -1,   -1,   -1,   -1,   -1,   -1,   -1,   -1,   -1,   -1,   -1,   -1,   -1,   -1,   -1],
    [  -1,   -1,   -1,   -1,   -1,   -1,   -1,   -1,   -1,   -1,   -1,   -1,   -1,   -1,   -1,   -1,   -1,   -1,   -1,   -1,   -1,   -1,   -1,   -1,   -1,   -1,   -1,   -1,   -1,   -1],
    [  -1,   -1,   -1,   -1,   -1,   -1,   -1,   -1,   -1,   -1,   -1,   -1,   -1,   -1,   -1,   -1,   -1,   -1,   -1,   -1,   -1,   -1,   -1,   -1,   -1,   -1,   -1,   -1,   -1,   -1],
    [  -1,   -1,  234,  235,  236,   -1,   -1,   -1,   -1,   -1,   -1,   -1,   -1,   -1,   -1,   -1,   -1,   -1,   -1,   -1,   -1,   -1,   -1,   -1,   -1,   -1,   -1,   -1,   -1,   -1],
    [  -1,   -1,  264,  265,  266,   -1,   -1,   -1,   -1,   -1,   -1,   -1,   -1,   -1,   -1,   -1,   -1,   -1,   -1,   -1,   -1,   -1,   -1,   -1,   -1,   -1,   -1,   -1,   -1,   -1],
    [  -1,   -1,  294,  295,  296,   -1,   -1,   -1,   -1,   -1,   -1,   -1,   -1,   -1,   -1,   -1,   -1,   -1,   -1,   -1,   -1,   -1,   -1,   -1,   -1,   -1,   -1,   -1,   -1,   -1],
    [  -1,   -1,   -1,   -1,   -1,   -1,   -1,   -1,   -1,   -1,   -1,   -1,   -1,   -1,   -1,   -1,   -1,   -1,   -1,   -1,   -1,   -1,   -1,   -1,   -1,   -1,   -1,   -1,   -1,   -1],
    [  -1,   -1,   -1,   -1,   -1,   -1,   -1,   -1,   -1,   -1,   -1,   -1,   -1,   -1,   -1,   -1,   -1,   -1,   -1,   -1,   -1,   -1,   -1,   -1,  234,  236,   -1,   -1,   -1,   -1],
    [  41,   -1,   -1,   -1,   -1,   -1,   -1,   -1,   -1,   -1,   -1,   -1,   -1,   -1,   -1,   -1,   -1,   -1,   -1,   -1,   -1,   -1,   -1,   -1,  294,  296,   -1,   -1,   -1,   -1],
    [  71,   -1,   -1,   -1,   -1,   -1,   -1,   -1,   -1,   -1,   -1,   -1,   -1,   -1,   -1,   -1,   -1,   -1,   -1,   -1,   -1,   -1,   -1,   -1,   -1,   -1,   -1,   -1,   -1,   -1],
    [ 101,   -1,   -1,   -1,   -1,   -1,   -1,   -1,   -1,   -1,   -1,   -1,   -1,   -1,   -1,   -1,   -1,   -1,   -1,   -1,   -1,   -1,   -1,   -1,   -1,   -1,  234,  235,  236,   -1],
    [  -1,   -1,   -1,   -1,   -1,   -1,   -1,   -1,   -1,   -1,   -1,   -1,  234,  235,  236,   -1,   -1,   -1,   -1,   -1,   -1,   -1,   -1,   -1,   -1,   -1,  264,  265,  266,   -1],
    [  -1,   -1,   -1,   -1,   -1,   -1,   -1,   -1,   -1,   -1,   -1,   -1,  264,  265,  266,   -1,   -1,   -1,  129,  130,  131,   -1,   -1,   -1,   -1,   -1,  294,  295,  296,   -1],
    [  -1,   -1,   -1,   -1,   -1,   -1,   -1,   -1,   -1,   -1,   -1,   -1,  294,  295,  296,   -1,   -1,   -1,   -1,   -1,   -1,   -1,   -1,   -1,   -1,   -1,   -1,   -1,   -1,   -1],
    [  23,   -1,   -1,   -1,   -1,   -1,  234,  236,   -1,   -1,   -1,   -1,   -1,   -1,   -1,   -1,   -1,   -1,   -1,   -1,   -1,   -1,   -1,   -1,   -1,   -1,   -1,   -1,   -1,   -1],
    [  -1,   22,   22,   23,   -1,   -1,  294,  296,   -1,   -1,   -1,   -1,   -1,   -1,   -1,   -1,   -1,   -1,   -1,   -1,   -1,   -1,   -1,  267,  268,   -1,   -1,   -1,   -1,   -1],
    [  -1,   -1,   -1,   -1,   23,   -1,   -1,   -1,   -1,   -1,   -1,   -1,   -1,   -1,   -1,   -1,   -1,   -1,   -1,   -1,   -1,   -1,   -1,   -1,   -1,   -1,   -1,   -1,   -1,   -1],
    [  -1,   -1,   -1,   -1,   -1,   23,   -1,   -1,   -1,   -1,   -1,   -1,   -1,   -1,   -1,   -1,   -1,   -1,   -1,   -1,   -1,   -1,   -1,   -1,   -1,   -1,   -1,   -1,   -1,   21],
    [  -1,   -1,   -1,   -1,   -1,    8,   -1,   -1,   -1,   -1,   -1,   -1,   -1,   -1,   -1,   -1,   -1,   -1,   -1,   -1,   -1,   -1,   -1,   -1,   -1,   -1,   -1,   21,   22,   -1],
    [  -1,   -1,   -1,   -1,   -1,    8,   -1,   -1,   -1,   -1,   -1,   -1,   -1,   -1,   -1,   -1,   -1,   -1,   -1,   -1,   -1,   -1,   -1,   -1,   -1,   -1,   -1,    6,   -1,   -1],
    [ 369,  370,  371,  372,   -1,    8,   -1,   -1,   -1,   -1,   -1,   -1,   -1,   -1,   -1,   -1,   -1,   -1,   -1,   -1,   -1,   -1,   -1,   -1,   -1,   -1,   -1,    6,   -1,   -1],
    [  -1,   -1,   -1,   -1,   -1,   -1,   23,   -1,   -1,   -1,   -1,   -1,   -1,   -1,   -1,   -1,   -1,   -1,   -1,   -1,   -1,   -1,   -1,   -1,   -1,   -1,   -1,    6,   -1,   -1],
    [  -1,   -1,   -1,   -1,   -1,   -1,   -1,   23,   -1,   -1,   -1,   -1,   -1,   -1,   -1,   -1,   -1,   -1,   -1,   -1,   -1,   -1,   -1,   -1,   -1,   -1,   21,    9,   -1,   -1],
    [  -1,   -1,   -1,   -1,   -1,   -1,   -1,   -1,   23,   -1,   -1,   -1,   -1,   -1,   -1,   -1,   -1,   -1,   -1,   -1,   -1,   -1,   21,   22,   22,   22,    9,   -1,   -1,   -1],
    [  -1,   -1,   -1,   -1,   -1,   -1,   -1,   -1,    8,   -1,   -1,   -1,   -1,   -1,   -1,   -1,   -1,   -1,   -1,   -1,   -1,   21,   -1,   -1,   -1,   -1,   -1,   -1,   -1,   -1],
    [  -1,   -1,   -1,   -1,   -1,   -1,   -1,   -1,   -1,   23,   -1,   -1,   -1,   -1,   -1,   -1,   -1,   -1,   -1,   -1,   21,   -1,   -1,   -1,   -1,   -1,   -1,   -1,   -1,   -1],
    [  -1,   -1,   -1,   -1,   -1,   -1,   -1,   -1,   -1,   -1,   22,   23,   -1,   -1,   -1,   -1,   -1,   -1,   -1,   -1,    6,   -1,   -1,   -1,   -1,   -1,   -1,   -1,   -1,   -1]
  ],
  "couche2": [
    [  -1,   -1,   -1,   -1,   -1,   -1,   -1,   -1,   -1,   -1,   -1,   -1,   -1,   -1,   -1,   -1,   -1,   -1,   -1,   -1,   -1,   -1,   -1,   -1,   -1,   -1,   -1,   -1,   -1,   -1],
    [  -1,   -1,   -1,   -1,   -1,   -1,   -1,   -1,   -1,   -1,   -1,   -1,   -1,   -1,   -1,   -1,   -1,   -1,   -1,   -1,   -1,   -1,   -1,   -1,   -1,   -1,   -1,   -1,   -1,   -1],
    [  -1,   -1,   -1,   -1,   -1,   -1,   -1,   -1,   -1,   -1,   -1,   -1,   -1,   -1,   -1,   -1,   -1,   -1,   -1,   -1,   -1,   -1,   -1,   -1,   -1,   -1,   -1,   -1,   -1,   -1],
    [  -1,   -1,   -1,   -1,   -1,   -1,   -1,   -1,   -1,   -1,   -1,   -1,   -1,   -1,   -1,   -1,   -1,   -1,   -1,   -1,   -1,   -1,   -1,   -1,   -1,   -1,   -1,   -1,   -1,   -1],
    [  -1,   -1,   -1,   -1,   -1,   -1,   -1,   -1,   -1,   -1,   -1,   -1,   -1,   -1,   -1,   -1,   -1,   -1,   -1,   -1,   -1,   -1,   -1,   -1,   -1,   -1,   -1,   -1,   -1,   -1],
    [  -1,   -1,   -1,   -1,   -1,   -1,   -1,   -1,   -1,   -1,   -1,   -1,   -1,   -1,   -1,   -1,   -1,   -1,   -1,   -1,   -1,   -1,   -1,   -1,   -1,   -1,   -1,   -1,   -1,   -1],
    [  -1,   -1,   -1,   -1,   -1,   -1,   -1,   -1,   -1,   -1,   -1,   -1,   -1,   -1,   -1,   -1,   -1,   -1,   -1,   -1,   -1,   -1,   -1,   -1,   -1,   -1,   -1,   -1,   -1,   -1],
    [  -1,   -1,   -1,   -1,   -1,   -1,   -1,   -1,   -1,   -1,   -1,   -1,   -1,   -1,   -1,   -1,   -1,   -1,   -1,   -1,   -1,   -1,   -1,   -1,   -1,   -1,   -1,   -1,   -1,   -1],
    [  -1,   -1,   -1,   -1,   -1,   -1,   -1,   -1,   -1,   -1,   -1,   -1,   -1,   -1,   -1,   -1,   -1,   -1,   -1,   -1,   -1,   -1,   -1,   -1,   -1,   -1,   -1,   -1,   -1,   -1],
    [  -1,   -1,   -1,   -1,   -1,   -1,   -1,   -1,   -1,   -1,   -1,   -1,   -1,   -1,   -1,   -1,   -1,   -1,   -1,   -1,   -1,   -1,   -1,   -1,   -1,   -1,   -1,   -1,   -1,   -1],
    [  -1,   -1,   -1,   -1,   -1,   -1,   -1,   -1,   -1,   -1,   -1,   -1,   -1,   -1,   -1,   -1,   -1,   -1,   -1,   -1,   -1,   -1,   -1,   -1,   -1,   -1,   -1,   -1,   -1,   -1],
    [  -1,   -1,   -1,   -1,   -1,   -1,   -1,   -1,   -1,   -1,   -1,   -1,   -1,   -1,   -1,   -1,   -1,   -1,   -1,   -1,   -1,   -1,   -1,   -1,   -1,   -1,   -1,   -1,   -1,   -1],
    [  -1,   -1,   -1,   -1,   -1,   -1,   -1,   -1,   -1,   -1,   -1,   -1,   -1,   -1,   -1,   -1,   -1,   -1,   -1,   -1,   -1,   -1,   -1,   -1,   -1,   -1,   -1,   -1,   -1,   -1],
    [  -1,   -1,   -1,   -1,   -1,   -1,   -1,   -1,   -1,   -1,   -1,   -1,   -1,   -1,   -1,   -1,   -1,   -1,   -1,   -1,   -1,   -1,   -1,   -1,   -1,   -1,   -1,   -1,   -1,   -1],
    [  -1,   -1,   -1,   -1,   -1,   -1,   -1,   -1,   -1,   -1,   -1,   -1,   -1,   -1,   -1,   -1,   -1,   -1,   -1,   -1,   -1,   -1,   -1,   -1,   -1,   -1,   -1,   -1,   -1,   -1],
    [  -1,   -1,   -1,   -1,   -1,   -1,   -1,   -1,   -1,   -1,   -1,   -1,   -1,   -1,   -1,   -1,   -1,   -1,   -1,   -1,   -1,   -1,   -1,   -1,   -1,   -1,   -1,   -1,   -1,   -1],
    [  -1,   -1,   -1,   -1,   -1,   -1,   -1,   -1,   -1,   -1,   -1,   -1,   -1,   -1,   -1,   -1,   -1,   -1,   -1,   -1,   -1,   -1,   -1,   -1,   -1,   -1,   -1,   -1,   -1,   -1],
    [  -1,   -1,   -1,   -1,   -1,   -1,   -1,   -1,   -1,   -1,   -1,   -1,   -1,   -1,   -1,   -1,   -1,   -1,   -1,   -1,   -1,   -1,   -1,   -1,   -1,   -1,   -1,   -1,   -1,   -1],
    [  -1,   -1,   -1,   -1,   -1,   -1,   -1,   -1,   -1,   -1,   -1,   -1,   -1,   -1,   -1,   -1,   -1,   -1,   -1,   -1,   -1,   -1,   -1,   -1,   -1,   -1,   -1,   -1,   -1,   -1],
    [  -1,   -1,   -1,   -1,   -1,   -1,   -1,   -1,   -1,   -1,   -1,   -1,   -1,   -1,   -1,   -1,   -1,   -1,   -1,   -1,   -1,   -1,   -1,   -1,   -1,   -1,   -1,   -1,   -1,   -1],
    [  -1,   -1,   -1,   -1,   -1,   -1,   -1,   -1,   -1,   -1,   -1,   -1,   -1,   -1,   -1,   -1,   -1,   -1,   -1,   -1,   -1,   -1,   -1,   -1,   -1,   -1,   -1,   -1,   -1,   -1],
    [  -1,   -1,   -1,   -1,   -1,   -1,   -1,   -1,   -1,   -1,   -1,   -1,   -1,   -1,   -1,   -1,   -1,   -1,   -1,   -1,   -1,   -1,   -1,   -1,   -1,   -1,   -1,   -1,   -1,   -1],
    [  -1,   -1,   -1,   -1,   -1,   -1,   -1,   -1,   -1,   -1,   -1,   -1,   -1,   -1,   -1,   -1,   -1,   -1,   -1,   -1,   -1,   -1,   -1,   -1,   -1,   -1,   -1,   -1,   -1,   -1],
    [  -1,   -1,   -1,   -1,   -1,   -1,   -1,   -1,   -1,   -1,   -1,   -1,   -1,   -1,   -1,   -1,   -1,   -1,   -1,   -1,   -1,   -1,   -1,   -1,   -1,   -1,   -1,   -1,   -1,   -1],
    [  -1,   -1,   -1,   -1,   -1,   -1,   -1,   -1,   -1,   -1,   -1,   -1,   -1,   -1,   -1,   -1,   -1,   -1,   -1,   -1,   -1,   -1,   -1,   -1,   -1,   -1,   -1,   -1,   -1,   -1],
    [  -1,   -1,   -1,   -1,   -1,   -1,   -1,   -1,   -1,   -1,   -1,   -1,   -1,   -1,   -1,   -1,   -1,   -1,   -1,   -1,   -1,   -1,   -1,   -1,   -1,   -1,   -1,   -1,   -1,   -1],
    [  -1,   -1,   -1,   -1,   -1,   -1,   -1,   -1,   -1,   -1,   -1,   -1,   -1,   -1,   -1,   -1,   -1,   -1,   -1,   -1,   -1,   -1,   -1,   -1,   -1,   -1,   -1,   -1,   -1,   -1],
    [  -1,   -1,   -1,   -1,   -1,   -1,   -1,   -1,   -1,   -1,   -1,   -1,   -1,   -1,   -1,   -1,   -1,   -1,   -1,   -1,   -1,   -1,   -1,  237,  238,   -1,   -1,   -1,   -1,   -1],
    [  -1,   -1,   -1,   -1,   -1,   -1,   -1,   -1,   -1,   -1,   -1,   -1,   -1,   -1,   -1,   -1,   -1,   -1,   -1,   -1,   -1,   -1,   -1,   -1,   -1,   -1,   -1,   -1,   -1,   -1],
    [ 249,  250,  251,  252,   -1,   -1,   -1,   -1,   -1,   -1,   -1,   -1,   -1,   -1,   -1,   -1,   -1,   -1,   -1,   -1,   -1,   -1,   -1,   -1,   -1,   -1,   -1,   -1,   -1,   -1],
    [ 279,  280,  281,  282,   -1,   -1,   -1,   -1,   -1,   -1,   -1,   -1,   -1,   -1,   -1,   -1,   -1,   -1,   -1,   -1,   -1,   -1,   -1,   -1,   -1,   -1,   -1,   -1,   -1,   -1],
    [ 309,  310,  311,  312,   -1,   -1,   -1,   -1,   -1,   -1,   -1,   -1,   -1,   -1,   -1,   -1,   -1,   -1,   -1,   -1,   -1,   -1,   -1,   -1,   -1,   -1,   -1,   -1,   -1,   -1],
    [ 339,  340,  341,  342,   -1,   -1,   -1,   -1,   -1,   -1,   -1,   -1,   -1,   -1,   -1,   -1,   -1,   -1,   -1,   -1,   -1,   -1,   -1,   -1,   -1,   -1,   -1,   -1,   -1,   -1],
    [  -1,   -1,   -1,   -1,   -1,   -1,   -1,   -1,   -1,   -1,   -1,   -1,   -1,   -1,   -1,   -1,   -1,   -1,   -1,   -1,   -1,   -1,   -1,   -1,   -1,   -1,   -1,   -1,   -1,   -1],
    [  -1,   -1,   -1,   -1,   -1,   -1,   -1,   -1,   -1,   -1,   -1,   -1,   -1,   -1,   -1,   -1,   -1,   -1,   -1,   -1,   -1,   -1,   -1,   -1,   -1,   -1,   -1,   -1,   -1,   -1],
    [  -1,   -1,   -1,   -1,   -1,   -1,   -1,   -1,   -1,   -1,   -1,   -1,   -1,   -1,   -1,   -1,   -1,   -1,   -1,   -1,   -1,   -1,   -1,   -1,   -1,   -1,   -1,   -1,   -1,   -1],
    [  -1,   -1,   -1,   -1,   -1,   -1,   -1,   -1,   -1,   -1,   -1,   -1,   -1,   -1,   -1,   -1,   -1,   -1,   -1,   -1,   -1,   -1,   -1,   -1,   -1,   -1,   -1,   -1,   -1,   -1],
    [  -1,   -1,   -1,   -1,   -1,   -1,   -1,   -1,   -1,   -1,   -1,   -1,   -1,   -1,   -1,   -1,   -1,   -1,   -1,   -1,   -1,   -1,   -1,   -1,   -1,   -1,   -1,   -1,   -1,   -1],
    [  -1,   -1,   -1,   -1,   -1,   -1,   -1,   -1,   -1,   -1,   -1,   -1,   -1,   -1,   -1,   -1,   -1,   -1,   -1,   -1,   -1,   -1,   -1,   -1,   -1,   -1,   -1,   -1,   -1,   -1],
    [  -1,   -1,   -1,   -1,   -1,   -1,   -1,   -1,   -1,   -1,   -1,   -1,   -1,   -1,   -1,   -1,   -1,   -1,   -1,   -1,   -1,   -1,   -1,   -1,   -1,   -1,   -1,   -1,   -1,   -1]
  ]
}