  -1   -1   -1   -1   -1   -1   -1   -1   -1   -1   -1   -1   -1   -1   -1   -1   -1   -1   -1   -1 
  -1   -1   -1   -1   -1   -1   -1   -1   -1   -1   -1   -1   -1   -1   -1   -1   -1   -1   -1   -1 
  -1   -1   -1   -1   -1   -1   -1   -1   -1   -1   -1   -1   -1   -1   -1   -1   -1   -1   -1   -1 
  -1   -1   -1   -1   -1   -1   -1   -1   -1   -1   -1   -1   -1   -1   -1   -1   -1   -1   -1   -1 
  -1   -1   -1   -1   -1   -1   -1   -1   -1   -1   -1   -1   -1   -1   -1   -1   -1   -1   -1   -1 
  -1   -1   -1   -1   -1   -1   -1   -1   -1   -1   -1   -1   -1  476  477  478   -1   -1   -1   -1 
  -1   -1   -1  476  477  478   -1   -1   -1   -1   -1   -1   -1   -1   -1   -1   -1   -1   -1   -1 
  -1   -1   -1   -1   -1   -1   -1   -1   -1   -1   -1   -1   -1   -1   -1   -1   -1   -1   -1   -1 
  -1   -1   -1  430   -1   -1  432   -1   -1   -1   -1   -1   -1   -1   -1   -1   -1   -1   -1   -1 
  -1   -1   -1   -1  234  235  236   -1   -1   -1   -1   -1   -1   -1   -1   -1   -1   -1   -1   -1 
 414   -1   -1   -1  264  265  266   -1   -1   -1   -1   -1   -1   -1   -1   -1   -1   -1   -1   -1 
  -1  414   -1   -1  294  295  296   -1   -1   -1   -1   -1   -1   -1   -1   -1   -1   -1   -1   -1 
  -1   -1   -1   -1   -1   -1  414   -1   -1   -1   -1   -1   -1  174  175  176  177  178   -1   -1 
  -1   -1   -1   -1   -1   -1   -1  414   -1   -1   -1   -1   -1  204  205  206  207  208   -1   -1 
  -1   -1   -1   -1   -1   -1   -1   -1  414   -1   -1   -1   -1   -1   -1   -1   -1   -1   -1   -1 
  -1   -1   -1   -1   -1   -1   -1   -1   -1  414   -1   -1  234  235  236   -1   -1   -1   -1   -1 
  -1   -1   -1   -1   -1   -1   -1   -1   -1   -1   -1   -1  264  265  266   -1   -1  267  268   -1 
  -1   -1   -1   -1   -1   -1   -1   -1   -1   -1   -1   -1  294  295  296   -1   -1   -1   -1   -1 