  -1   -1   -1   -1   -1   -1   -1   -1   -1   -1   -1   -1   -1   -1   -1   -1   -1   -1   -1   -1 
  -1   -1   -1   -1   -1   -1   -1   24   25   26   -1   -1   -1   -1   -1   -1   -1   -1   -1   -1 
  -1   -1   -1   -1  280  281   -1   60   61   62   -1  280  281   -1   -1   -1   -1   -1   -1   -1 
  -1   -1   -1   -1  316  317   -1   96   97   98   -1  316  317   -1   -1   -1   -1   -1   -1   -1 
  -1   -1   -1   -1  352  353   -1  132  133  134   -1  352  353   -1   -1   -1   -1   -1   -1   -1 
  -1   -1   -1   -1   -1   -1   -1  168  169  170   -1   -1   -1   -1   -1  309  310  311   -1   -1 
  -1   -1   -1   -1   -1   -1   -1   -1   -1   -1   -1   -1   -1   -1   -1  345  346  347   -1   -1 
  -1   -1   -1   -1  559   -1   -1   -1   -1   -1   -1   -1  558   -1   -1  381  382  383   -1   -1 
  -1   -1   -1   -1   -1   -1   -1   -1   -1   -1   -1   -1   -1   -1   -1   -1   -1   -1   -1   -1 
  -1   -1   -1   -1   -1   -1   -1   -1   -1   -1   -1   -1   -1   -1   -1   -1   -1   -1   -1   -1 
  -1   -1   -1   -1   -1   -1   -1   -1   -1   -1   -1   -1   -1   -1   -1   -1   -1   -1  560   -1 
  -1   -1   -1   -1   -1   -1   -1   -1   -1   -1   -1   -1   -1   -1   -1   -1   -1   -1   -1   -1 
  -1   -1   -1   -1   -1   -1   -1   -1   -1   -1   -1   -1   -1   -1   -1   -1   -1   -1   -1   -1 
  -1   -1   -1   -1  207  208  209   -1   -1   -1   -1   -1  204  205  206   -1   -1   -1   -1   -1 
  -1   -1   -1   -1   -1   -1   -1   -1   -1   -1   -1   -1   -1   -1   -1   -1   -1   -1   -1   -1 