{
  "largeur": 20,
  "hauteur": 15,
  "chipset": "chipset175.png",
  "musique": "mystery3.ogg",
  "couche0": [
    [ 197,  253,  253,  253,  253,  253,  253,  253,  253,  253,  253,  253,  253,  253,  253,  253,  253,  253,  253,  196],
    [ 218,  517,  517,  517,  517,  517,  517,  517,  517,  517,  517,  517,  517,  517,  517,  517,  517,  517,  517,  216],
    [ 218,  517,  517,  517,  517,  517,  517,  517,  517,  517,  517,  517,  517,  517,  517,  517,  517,  517,  517,  216],
    [ 254,  553,  553,  553,  553,  553,  553,  553,  553,  553,  553,  553,  553,  553,  553,  553,  553,  553,  553,  252],
    [ 517,  508,  508,  508,  508,  508,  508,  509,  436,  507,  508,  508,  508,  508,  508,  508,  508,  508,  508,  517],
    [ 517,  508,  508,  508,  508,  508,  508,  509,  436,  507,  508,  508,  508,  508,  508,  508,  508,  508,  508,  517],
    [ 553,  508,  508,  508,  508,  508,  508,  509,  436,  543,  508,  508,  508,  508,  508,  508,  508,  508,  508,  553],
    [ 476,  508,  508,  508,  508,  508,  508,  508,  473,  436,  507,  508,  508,  508,  508,  508,  508,  508,  508,  474],
    [ 512,  508,  508,  508,  508,  508,  508,  508,  508,  472,  508,  544,  508,  508,  508,  508,  508,  508,  508,  510],
    [ 548,  508,  508,  508,  508,  508,  508,  508,  508,  508,  545,  435,  507,  508,  508,  508,  508,  508,  508,  546],
    [ 182,  508,  508,  508,  508,  508,  508,  508,  508,  545,  436,  436,  507,  508,  508,  508,  508,  508,  508,  180],
    [ 218,  508,  508,  508,  508,  508,  508,  508,  509,  436,  436,  471,  508,  508,  508,  508,  508,  508,  508,  216],
    [ 218,  508,  508,  508,  508,  508,  508,  508,  545,  436,  436,  507,  508,  508,  508,  508,  508,  508,  508,  216],
    [ 218,  508,  508,  508,  508,  508,  508,  509,  436,  435,  436,  507,  508,  508,  508,  508,  508,  508,  508,  216],
    [ 161,  181,  181,  181,  181,  181,  181,  182,  436,  436,  436,  180,  181,  181,  181,  181,  181,  181,  181,  160]
  ],
  "couche1": [
    [  -1,   -1,   -1,   -1,   -1,   -1,   -1,   -1,   -1,   -1,   -1,   -1,   -1,   -1,   -1,   -1,   -1,   -1,   -1,   -1],
    [  -1,   -1,   -1,   -1,   -1,   -1,   -1,   24,   25,   26,   -1,   -1,   -1,   -1,   -1,   -1,   -1,   -1,   -1,   -1],
    [  -1,   -1,   -1,   -1,  280,  281,   -1,   60,   61,   62,   -1,  280,  281,   -1,   -1,   -1,   -1,   -1,   -1,   -1],
    [  -1,   -1,   -1,   -1,  316,  317,   -1,   96,   97,   98,   -1,  316,  317,   -1,   -1,   -1,   -1,   -1,   -1,   -1],
    [  -1,   -1,   -1,   -1,  352,  353,   -1,  132,  133,  134,   -1,  352,  353,   -1,   -1,   -1,   -1,   -1,   -1,   -1],
    [  -1,   -1,   -1,   -1,   -1,   -1,   -1,  168,  169,  170,   -1,   -1,   -1,   -1,   -1,  309,  310,  311,   -1,   -1],
    [  -1,   -1,   -1,   -1,   -1,   -1,   -1,   -1,   -1,   -1,   -1,   -1,   -1,   -1,   -1,  345,  346,  347,   -1,   -1],
    [  -1,   -1,   -1,   -1,  559,   -1,   -1,   -1,   -1,   -1,   -1,   -1,  558,   -1,   -1,  381,  382,  383,   -1,   -1],
    [  -1,   -1,   -1,   -1,   -1,   -1,   -1,   -1,   -1,   -1,   -1,   -1,   -1,   -1,   -1,   -1,   -1,   -1,   -1,   -1],
    [  -1,   -1,   -1,   -1,   -1,   -1,   -1,   -1,   -1,   -1,   -1,   -1,   -1,   -1,   -1,   -1,   -1,   -1,   -1,   -1],
    [  -1,   -1,   -1,   -1,   -1,   -1,   -1,   -1,   -1,   -1,   -1,   -1,   -1,   -1,   -1,   -1,   -1,   -1,  560,   -1],
    [  -1,   -1,   -1,   -1,   -1,   -1,   -1,   -1,   -1,   -1,   -1,   -1,   -1,   -1,   -1,   -1,   -1,   -1,   -1,   -1],
    [  -1,   -1,   -1,   -1,   -1,   -1,   -1,   -1,   -1,   -1,   -1,   -1,   -1,   -1,   -1,   -1,   -1,   -1,   -1,   -1],
    [  -1,   -1,   -1,   -1,  207,  208,  209,   -1,   -1,   -1,   -1,   -1,  204,  205,  206,   -1,   -1,   -1,   -1,   -1],
    [  -1,   -1,   -1,   -1,   -1,   -1,   -1,   -1,   -1,   -1,   -1,   -1,   -1,   -1,   -1,   -1,   -1,   -1,   -1,   -1]
  ],
  "couche2": [
    [  -1,   -1,   -1,   -1,   -1,   -1,   -1,   -1,   -1,   -1,   -1,   -1,   -1,   -1,   -1,   -1,   -1,   -1,   -1,   -1],
    [  -1,   -1,   -1,   -1,   -1,   -1,   -1,   -1,   -1,   -1,   -1,   -1,   -1,   -1,   -1,   -1,   -1,   -1,   -1,   -1],
    [  -1,   -1,   -1,   -1,   -1,   -1,   -1,   -1,   -1,   -1,   -1,   -1,   -1,   -1,   -1,   -1,   -1,   -1,   -1,   -1],
    [  -1,   -1,   -1,   -1,   -1,   -1,   -1,   -1,   -1,   -1,   -1,   -1,   -1,   -1,   -1,   -1,   -1,   -1,   -1,   -1],
    [  -1,   -1,   -1,   -1,   -1,   -1,   -1,   -1,   -1,   -1,   -1,   -1,   -1,   -1,   -1,   -1,   -1,   -1,   -1,   -1],
    [  -1,   -1,   -1,   -1,   -1,   -1,   -1,   -1,   -1,   -1,   -1,   -1,   -1,   -1,   -1,   -1,   -1,   -1,   -1,   -1],
    [  -1,   -1,   -1,   -1,   -1,   -1,   -1,   -1,   -1,   -1,   -1,   -1,   -1,   -1,   -1,   -1,   -1,   -1,   -1,   -1],
    [  -1,   -1,   -1,   -1,   -1,   -1,   -1,   -1,   -1,   -1,   -1,   -1,   -1,   -1,   -1,   -1,   -1,   -1,   -1,   -1],
    [  -1,   -1,   -1,   -1,   -1,   -1,   -1,   -1,   -1,   -1,   -1,   -1,   -1,   -1,   -1,   -1,   -1,   -1,   -1,   -1],
    [  -1,   -1,   -1,   -1,   -1,   -1,   -1,   -1,   -1,   -1,   -1,   -1,   -1,   -1,   -1,   -1,   -1,   -1,   -1,   -1],
    [  -1,   -1,   -1,   -1,   -1,   -1,   -1,   -1,   -1,   -1,   -1,   -1,   -1,   -1,   -1,   -1,   -1,   -1,   -1,   -1],
    [  -1,   -1,   -1,  417,   -1,   -1,   -1,  416,   -1,   -1,   -1,  417,   -1,   -1,   -1,  417,   -1,   -1,   -1,   -1],
    [  -1,   -1,   -1,  453,   -1,   -1,   -1,  452,   -1,   -1,   -1,  453,   -1,   -1,   -1,  453,   -1,   -1,   -1,   -1],
    [  -1,   -1,   -1,  489,   -1,   -1,   -1,  488,   -1,   -1,   -1,  489,   -1,   -1,   -1,  489,   -1,   -1,   -1,   -1],
    [  -1,   -1,   -1,   -1,   -1,   -1,   -1,   -1,   -1,   -1,   -1,   -1,   -1,   -1,   -1,   -1,   -1,   -1,   -1,   -1]
  ]
}