 197  253  253  253  253  253  253  253  253  253  253  253  253  253  253  253  253  253  253  196 
 218  517  517  517  517  517  517  517  517  517  517  517  517  517  517  517  517  517  517  216 
 218  517  517  517  517  517  517  517  517  517  517  517  517  517  517  517  517  517  517  216 
 254  553  553  553  553  553  553  553  553  553  553  553  553  553  553  553  553  553  553  252 
 517  508  508  508  508  508  508  509  436  507  508  508  508  508  508  508  508  508  508  517 
 517  508  508  508  508  508  508  509  436  507  508  508  508  508  508  508  508  508  508  517 
 553  508  508  508  508  508  508  509  436  543  508  508  508  508  508  508  508  508  508  553 
 476  508  508  508  508  508  508  508  473  436  507  508  508  508  508  508  508  508  508  474 
 512  508  508  508  508  508  508  508  508  472  508  544  508  508  508  508  508  508  508  510 
 548  508  508  508  508  508  508  508  508  508  545  435  507  508  508  508  508  508  508  546 
 182  508  508  508  508  508  508  508  508  545  436  436  507  508  508  508  508  508  508  180 
 218  508  508  508  508  508  508  508  509  436  436  471  508  508  508  508  508  508  508  216 
 218  508  508  508  508  508  508  508  545  436  436  507  508  508  508  508  508  508  508  216 
 218  508  508  508  508  508  508  509  436  435  436  507  508  508  508  508  508  508  508  216 
 161  181  181  181  181  181  181  182  436  436  436  180  181  181  181  181  181  181  181  160 