  -1   -1   -1   -1   -1   -1   -1   -1   -1   -1   -1   -1   -1   -1   -1 
  -1   -1  300   -1   -1   -1   24   25   26   -1   -1   -1  300   -1   -1 
  -1   -1  336  280  281   -1   60   61   62   -1  280  281  336   -1   -1 
  -1   -1   -1  316  317   -1   96   97   98   -1  316  317   -1   -1   -1 
  -1   -1   -1  352  353   -1  132  133  134   -1  352  353   -1   -1   -1 
  -1   -1   -1   -1   -1   -1  168  169  170   -1   -1   -1   -1   -1   -1 
  -1   -1   -1   -1   -1   -1   -1   -1   -1   -1   -1   -1   -1   -1   -1 
  -1   -1   -1   -1   -1   -1   -1   -1   -1   -1   -1   -1   -1   -1   -1 
  -1   -1   -1   -1   -1   -1   -1   -1   -1   -1   -1   -1   -1   -1   -1 
  -1   -1   -1   -1   -1   -1   -1   -1   -1   -1   -1   -1   -1   -1   -1 
  -1   -1  560  265   -1   -1   -1   -1   -1  563   -1  163  164   -1   -1 
  -1   -1   -1   -1   -1   -1   -1   -1   -1   -1   -1   -1   -1   -1   -1 
  -1   -1   -1   -1   -1   -1   -1   -1   -1  558   -1   -1   -1   -1   -1 
  -1   -1   -1   -1   -1   -1   -1   -1   -1   -1   -1   -1   -1   -1   -1 
  -1   -1   -1   -1   -1   -1   -1   -1   -1   -1   -1   -1   -1   -1   -1 