  -1   -1   -1   -1   -1   -1   -1   -1   -1   -1   -1   -1   -1   -1   -1   -1   -1   -1   -1   -1   -1   -1   -1   -1   -1   -1   -1   -1   -1   -1 
  -1   -1   -1   -1   27   28   29   -1  300   -1   -1  301   -1   24   25   26   -1  300   -1   -1   -1   -1   -1   -1   -1   -1  300   -1   -1   -1 
  -1   -1   -1   -1   63   64   65   -1  336   -1  302  337   -1   60   61   62   -1  336   -1   -1  280  281  280  281   -1   -1  336   -1   -1   -1 
  -1   -1   -1   -1   99  100  101   -1   -1   -1  338  338   -1   96   97   98   -1   -1   -1   -1  316  317  316  317   -1   -1   -1   -1   -1   -1 
  -1  559   -1   -1  135  136  137   -1   -1   -1   -1   -1  198  132  133  134   -1   -1   -1   -1  352  353  352  353   -1   -1   -1   -1   -1   -1 
  -1   -1   -1   -1  171  172  173   -1   -1   -1   -1   -1  234  168  195  170  243  244  245   -1   -1   -1   -1   -1   -1   -1   -1   -1   -1   -1 
  -1   -1  385  386   -1   -1   -1   -1   -1   -1   -1   -1  237  163  164  165   -1   -1   -1   -1   -1   -1   -1   -1   -1   -1   -1   -1   -1   -1 
  -1   -1   -1   -1   -1   -1   -1   -1   -1   -1   -1   -1   -1  199  200  201   -1   -1   -1   -1   -1   -1   -1   -1   -1   -1   -1   -1   -1   -1 
  -1  558   -1   -1   -1   -1   -1   -1   -1   -1   -1   -1   -1   -1   -1   -1   -1   -1   -1   -1   -1   -1   -1   -1   -1   -1   -1   -1   -1   -1 
  -1  136   -1   -1   -1   -1   -1   -1   -1   -1   -1   -1   -1   -1   -1   -1   -1   -1   -1   -1   -1  202  203   -1   -1   -1   -1   -1   -1   -1 
  -1  172   -1   -1   -1   -1   -1   -1   -1  560   -1   -1   -1   -1   -1   -1   -1   -1   -1   -1   -1  238  239   -1   -1   -1   -1   -1   -1   -1 
  -1  312   -1   -1   -1   -1   -1   -1   -1   -1   -1   -1   -1   -1   -1   -1   -1   -1   -1   -1   -1   -1   -1   -1   -1   -1   -1   -1   -1   -1 
  -1  348   -1   -1   -1   -1   -1   -1  205  206   -1   -1   -1   -1   -1   -1   -1  274   -1   -1   -1   -1   -1   -1   -1   -1   -1   -1   -1   -1 
  -1   -1   -1   -1   -1   -1   -1   -1  241  242   -1   -1   -1   -1   -1   -1   -1   -1   -1   -1   -1   -1   -1   -1   -1   -1   -1   -1   -1   -1 
  -1   -1   -1   -1   -1   -1   -1   -1   -1   -1   -1   -1   -1   -1   -1   -1   -1   -1   -1   -1   -1   -1   -1   -1   -1   -1   -1   -1   -1   -1 