 197  253  253  253  253  253  253  253  253  253  253  253  253  253  253  253  253  253  253  253  253  253  253  253  253  253  253  253  253  196 
 218  298  298  298  298  298  298  298  298  298  298  298  298  298  298  298  298  298  298  298  298  298  298  298  298  298  298  298  298  216 
 218  298  298  298  298  298  298  298  298  298  298  298  298  298  298  298  298  298  298  298  298  298  298  298  298  298  298  298  298  216 
 218  334  334  334  334  334  334  334  334  334  334  334  334  334  334  334  334  334  334  334  334  334  334  334  334  334  334  334  334  252 
 218  508  508  508  508  508  508  508  508  509  436  436  436  507  508  508  508  508  508  508  508  508  508  508  508  508  508  508  508  298 
 218  508  508  508  508  508  508  508  508  508  473  435  436  543  544  544  508  508  508  508  508  508  508  437  508  508  437  508  508  298 
 218  508  508  508  437  508  508  508  508  437  509  436  436  436  436  436  543  508  508  508  508  437  508  508  508  508  508  437  545  334 
 218  508  508  508  508  508  508  437  508  508  508  472  473  436  436  436  436  507  508  508  508  508  508  508  508  508  508  509  435  471 
 218  508  508  508  508  544  544  508  508  508  508  508  508  473  436  435  436  507  508  437  508  544  544  508  508  437  508  509  436  507 
 218  508  437  508  545  436  436  507  508  508  508  508  508  509  436  436  471  508  508  508  545  436  436  543  544  544  508  509  436  543 
 218  508  508  509  436  435  471  508  437  508  508  437  508  508  472  472  544  544  544  508  473  436  436  436  435  436  507  508  473  180 
 218  508  508  508  473  436  507  508  508  508  508  508  508  508  508  545  436  436  436  507  508  472  472  472  472  472  508  508  508  216 
 218  508  508  437  508  472  508  508  508  508  508  508  508  544  545  436  436  436  436  507  508  508  508  508  437  508  508  508  508  216 
 218  508  508  508  508  508  508  437  508  508  508  508  509  436  436  435  471  472  472  435  508  508  508  508  508  508  508  508  508  216 
 161  181  181  181  181  181  181  181  181  181  181  181  182  471  472  473  180  181  181  181  181  181  181  181  181  181  181  181  181  160 