{
  "largeur": 30,
  "hauteur": 15,
  "chipset": "chipset175.png",
  "musique": "mystery3.ogg",
  "couche0": [
    [ 197,  253,  253,  253,  253,  253,  253,  253,  253,  253,  253,  253,  253,  253,  253,  253,  253,  253,  253,  253,  253,  253,  253,  253,  253,  253,  253,  253,  253,  196],
    [ 218,  298,  298,  298,  298,  298,  298,  298,  298,  298,  298,  298,  298,  298,  298,  298,  298,  298,  298,  298,  298,  298,  298,  298,  298,  298,  298,  298,  298,  216],
    [ 218,  298,  298,  298,  298,  298,  298,  298,  298,  298,  298,  298,  298,  298,  298,  298,  298,  298,  298,  298,  298,  298,  298,  298,  298,  298,  298,  298,  298,  216],
    [ 218,  334,  334,  334,  334,  334,  334,  334,  334,  334,  334,  334,  334,  334,  334,  334,  334,  334,  334,  334,  334,  334,  334,  334,  334,  334,  334,  334,  334,  252],
    [ 218,  508,  508,  508,  508,  508,  508,  508,  508,  509,  436,  436,  436,  507,  508,  508,  508,  508,  508,  508,  508,  508,  508,  508,  508,  508,  508,  508,  508,  298],
    [ 218,  508,  508,  508,  508,  508,  508,  508,  508,  508,  473,  435,  436,  543,  544,  544,  508,  508,  508,  508,  508,  508,  508,  437,  508,  508,  437,  508,  508,  298],
    [ 218,  508,  508,  508,  437,  508,  508,  508,  508,  437,  509,  436,  436,  436,  436,  436,  543,  508,  508,  508,  508,  437,  508,  508,  508,  508,  508,  437,  545,  334],
    [ 218,  508,  508,  508,  508,  508,  508,  437,  508,  508,  508,  472,  473,  436,  436,  436,  436,  507,  508,  508,  508,  508,  508,  508,  508,  508,  508,  509,  435,  471],
    [ 218,  508,  508,  508,  508,  544,  544,  508,  508,  508,  508,  508,  508,  473,  436,  435,  436,  507,  508,  437,  508,  544,  544,  508,  508,  437,  508,  509,  436,  507],
    [ 218,  508,  437,  508,  545,  436,  436,  507,  508,  508,  508,  508,  508,  509,  436,  436,  471,  508,  508,  508,  545,  436,  436,  543,  544,  544,  508,  509,  436,  543],
    [ 218,  508,  508,  509,  436,  435,  471,  508,  437,  508,  508,  437,  508,  508,  472,  472,  544,  544,  544,  508,  473,  436,  436,  436,  435,  436,  507,  508,  473,  180],
    [ 218,  508,  508,  508,  473,  436,  507,  508,  508,  508,  508,  508,  508,  508,  508,  545,  436,  436,  436,  507,  508,  472,  472,  472,  472,  472,  508,  508,  508,  216],
    [ 218,  508,  508,  437,  508,  472,  508,  508,  508,  508,  508,  508,  508,  544,  545,  436,  436,  436,  436,  507,  508,  508,  508,  508,  437,  508,  508,  508,  508,  216],
    [ 218,  508,  508,  508,  508,  508,  508,  437,  508,  508,  508,  508,  509,  436,  436,  435,  471,  472,  472,  435,  508,  508,  508,  508,  508,  508,  508,  508,  508,  216],
    [ 161,  181,  181,  181,  181,  181,  181,  181,  181,  181,  181,  181,  182,  471,  472,  473,  180,  181,  181,  181,  181,  181,  181,  181,  181,  181,  181,  181,  181,  160]
  ],
  "couche1": [
    [  -1,   -1,   -1,   -1,   -1,   -1,   -1,   -1,   -1,   -1,   -1,   -1,   -1,   -1,   -1,   -1,   -1,   -1,   -1,   -1,   -1,   -1,   -1,   -1,   -1,   -1,   -1,   -1,   -1,   -1],
    [  -1,   -1,   -1,   -1,   27,   28,   29,   -1,  300,   -1,   -1,  301,   -1,   24,   25,   26,   -1,  300,   -1,   -1,   -1,   -1,   -1,   -1,   -1,   -1,  300,   -1,   -1,   -1],
    [  -1,   -1,   -1,   -1,   63,   64,   65,   -1,  336,   -1,  302,  337,   -1,   60,   61,   62,   -1,  336,   -1,   -1,  280,  281,  280,  281,   -1,   -1,  336,   -1,   -1,   -1],
    [  -1,   -1,   -1,   -1,   99,  100,  101,   -1,   -1,   -1,  338,  338,   -1,   96,   97,   98,   -1,   -1,   -1,   -1,  316,  317,  316,  317,   -1,   -1,   -1,   -1,   -1,   -1],
    [  -1,  559,   -1,   -1,  135,  136,  137,   -1,   -1,   -1,   -1,   -1,  198,  132,  133,  134,   -1,   -1,   -1,   -1,  352,  353,  352,  353,   -1,   -1,   -1,   -1,   -1,   -1],
    [  -1,   -1,   -1,   -1,  171,  172,  173,   -1,   -1,   -1,   -1,   -1,  234,  168,  195,  170,  243,  244,  245,   -1,   -1,   -1,   -1,   -1,   -1,   -1,   -1,   -1,   -1,   -1],
    [  -1,   -1,  385,  386,   -1,   -1,   -1,   -1,   -1,   -1,   -1,   -1,  237,  163,  164,  165,   -1,   -1,   -1,   -1,   -1,   -1,   -1,   -1,   -1,   -1,   -1,   -1,   -1,   -1],
    [  -1,   -1,   -1,   -1,   -1,   -1,   -1,   -1,   -1,   -1,   -1,   -1,   -1,  199,  200,  201,   -1,   -1,   -1,   -1,   -1,   -1,   -1,   -1,   -1,   -1,   -1,   -1,   -1,   -1],
    [  -1,  558,   -1,   -1,   -1,   -1,   -1,   -1,   -1,   -1,   -1,   -1,   -1,   -1,   -1,   -1,   -1,   -1,   -1,   -1,   -1,   -1,   -1,   -1,   -1,   -1,   -1,   -1,   -1,   -1],
    [  -1,  136,   -1,   -1,   -1,   -1,   -1,   -1,   -1,   -1,   -1,   -1,   -1,   -1,   -1,   -1,   -1,   -1,   -1,   -1,   -1,  202,  203,   -1,   -1,   -1,   -1,   -1,   -1,   -1],
    [  -1,  172,   -1,   -1,   -1,   -1,   -1,   -1,   -1,  560,   -1,   -1,   -1,   -1,   -1,   -1,   -1,   -1,   -1,   -1,   -1,  238,  239,   -1,   -1,   -1,   -1,   -1,   -1,   -1],
    [  -1,  312,   -1,   -1,   -1,   -1,   -1,   -1,   -1,   -1,   -1,   -1,   -1,   -1,   -1,   -1,   -1,   -1,   -1,   -1,   -1,   -1,   -1,   -1,   -1,   -1,   -1,   -1,   -1,   -1],
    [  -1,  348,   -1,   -1,   -1,   -1,   -1,   -1,  205,  206,   -1,   -1,   -1,   -1,   -1,   -1,   -1,  274,   -1,   -1,   -1,   -1,   -1,   -1,   -1,   -1,   -1,   -1,   -1,   -1],
    [  -1,   -1,   -1,   -1,   -1,   -1,   -1,   -1,  241,  242,   -1,   -1,   -1,   -1,   -1,   -1,   -1,   -1,   -1,   -1,   -1,   -1,   -1,   -1,   -1,   -1,   -1,   -1,   -1,   -1],
    [  -1,   -1,   -1,   -1,   -1,   -1,   -1,   -1,   -1,   -1,   -1,   -1,   -1,   -1,   -1,   -1,   -1,   -1,   -1,   -1,   -1,   -1,   -1,   -1,   -1,   -1,   -1,   -1,   -1,   -1]
  ],
  "couche2": [
    [  -1,   -1,   -1,   -1,   -1,   -1,   -1,   -1,   -1,   -1,   -1,   -1,   -1,   -1,   -1,   -1,   -1,   -1,   -1,   -1,   -1,   -1,   -1,   -1,   -1,   -1,   -1,   -1,   -1,   -1],
    [  -1,   -1,   -1,   -1,   -1,   -1,   -1,   -1,   -1,   -1,   -1,   -1,   -1,   -1,   -1,   -1,   -1,   -1,   -1,   -1,   -1,   -1,   -1,   -1,   -1,   -1,   -1,   -1,   -1,   -1],
    [  -1,   -1,   -1,   -1,   -1,   -1,   -1,   -1,   -1,   -1,   -1,   -1,   -1,   -1,   -1,   -1,   -1,   -1,   -1,   -1,   -1,   -1,   -1,   -1,   -1,   -1,   -1,   -1,   -1,   -1],
    [  -1,   -1,   -1,   -1,   -1,   -1,   -1,   -1,   -1,   -1,   -1,   -1,   -1,   -1,   -1,   -1,   -1,   -1,   -1,   -1,   -1,   -1,   -1,   -1,   -1,   -1,   -1,   -1,   -1,   -1],
    [  -1,   -1,   -1,   -1,   -1,   -1,   -1,   -1,   -1,   -1,   -1,   -1,   -1,   -1,   -1,   -1,  207,  208,  209,   -1,   -1,   -1,   -1,   -1,   -1,   -1,   -1,   -1,   -1,   -1],
    [  -1,   -1,  349,  350,   -1,   -1,   -1,   -1,   -1,   -1,   -1,   -1,   -1,   -1,   -1,   -1,   -1,   -1,   -1,   -1,   -1,   -1,   -1,   -1,   -1,   -1,   -1,   -1,   -1,   -1],
    [  -1,   -1,   -1,   -1,   -1,   -1,   -1,   -1,   -1,   -1,   -1,   -1,   -1,   -1,   -1,   -1,   -1,   -1,   -1,   -1,   -1,   -1,   -1,   -1,   -1,   -1,   -1,   -1,   -1,   -1],
    [  -1,   -1,   -1,   -1,   -1,   -1,   -1,   -1,   -1,   -1,   -1,   -1,   -1,   -1,   -1,   -1,   -1,   -1,   -1,   -1,   -1,   -1,   -1,   -1,   -1,   -1,   -1,   -1,   -1,   -1],
    [  -1,   -1,   -1,   -1,   -1,   -1,   -1,   -1,   -1,   -1,   -1,   -1,   -1,   -1,   -1,   -1,   -1,   -1,   -1,   -1,   -1,   -1,   -1,   -1,   -1,   -1,   -1,   -1,   -1,   -1],
    [  -1,   -1,   -1,   -1,   -1,   -1,   -1,   -1,   -1,   -1,   -1,   -1,   -1,   -1,   -1,   -1,   -1,   -1,   -1,   -1,   -1,   -1,   -1,   -1,   -1,   -1,   -1,   -1,   -1,   -1],
    [  -1,   -1,   -1,   -1,   -1,   -1,   -1,   -1,   -1,   -1,   -1,   -1,   -1,   -1,   -1,   -1,   -1,   -1,   -1,   -1,   -1,   -1,   -1,   -1,   -1,   -1,   -1,   -1,   -1,   -1],
    [  -1,   -1,   -1,   -1,   -1,   -1,   -1,   -1,   -1,   -1,   -1,   -1,   -1,   -1,   -1,   -1,   -1,  204,   -1,   -1,   -1,   -1,   -1,   -1,   -1,   -1,   -1,   -1,   -1,   -1],
    [  -1,   -1,   -1,   -1,   -1,   -1,   -1,   -1,   -1,   -1,   -1,   -1,   -1,   -1,   -1,   -1,   -1,   -1,   -1,   -1,   -1,   -1,   -1,   -1,   -1,   -1,   -1,   -1,   -1,   -1],
    [  -1,   -1,   -1,   -1,   -1,   -1,   -1,   -1,   -1,   -1,   -1,   -1,   -1,   -1,   -1,   -1,   -1,   -1,   -1,   -1,   -1,   -1,   -1,   -1,   -1,   -1,   -1,   -1,   -1,   -1],
    [  -1,   -1,   -1,   -1,   -1,   -1,   -1,   -1,   -1,   -1,   -1,   -1,   -1,   -1,   -1,   -1,   -1,   -1,   -1,   -1,   -1,   -1,   -1,   -1,   -1,   -1,   -1,   -1,   -1,   -1]
  ]
}