{
  "largeur": 15,
  "hauteur": 15,
  "chipset": "chipset175.png",
  "musique": "mystery3.ogg",
  "couche0": [
    [ 197,  256,  256,  256,  256,  256,  256,  256,  256,  256,  256,  256,  256,  256,  196],
    [ 221,  298,  298,  298,  298,  298,  298,  298,  298,  298,  298,  298,  298,  298,  219],
    [ 221,  298,  298,  298,  298,  298,  298,  298,  298,  298,  298,  298,  298,  298,  219],
    [ 221,  334,  334,  334,  334,  334,  334,  334,  334,  334,  334,  334,  334,  334,  219],
    [ 221,  508,  508,  508,  437,  508,  508,  508,  508,  508,  508,  508,  508,  508,  219],
    [ 221,  508,  437,  508,  508,  508,  508,  508,  508,  508,  508,  508,  437,  508,  219],
    [ 221,  508,  508,  508,  508,  508,  508,  435,  437,  508,  437,  508,  508,  508,  219],
    [ 221,  508,  508,  508,  508,  437,  508,  508,  435,  508,  508,  508,  508,  508,  219],
    [ 221,  508,  508,  508,  508,  508,  508,  508,  544,  508,  508,  508,  437,  508,  219],
    [ 221,  508,  508,  508,  508,  508,  508,  509,  436,  543,  544,  544,  544,  508,  219],
    [ 221,  508,  508,  508,  437,  508,  508,  545,  436,  436,  436,  436,  436,  507,  219],
    [ 221,  508,  508,  508,  508,  508,  545,  436,  436,  436,  436,  436,  471,  508,  219],
    [ 221,  508,  437,  508,  508,  509,  436,  436,  436,  436,  472,  472,  437,  508,  219],
    [ 221,  508,  508,  508,  508,  509,  436,  436,  436,  471,  437,  508,  508,  437,  219],
    [ 161,  184,  184,  184,  184,  185,  471,  472,  473,  183,  184,  184,  184,  184,  160]
  ],
  "couche1": [
    [  -1,   -1,   -1,   -1,   -1,   -1,   -1,   -1,   -1,   -1,   -1,   -1,   -1,   -1,   -1],
    [  -1,   -1,  300,   -1,   -1,   -1,   24,   25,   26,   -1,   -1,   -1,  300,   -1,   -1],
    [  -1,   -1,  336,  280,  281,   -1,   60,   61,   62,   -1,  280,  281,  336,   -1,   -1],
    [  -1,   -1,   -1,  316,  317,   -1,   96,   97,   98,   -1,  316,  317,   -1,   -1,   -1],
    [  -1,   -1,   -1,  352,  353,   -1,  132,  133,  134,   -1,  352,  353,   -1,   -1,   -1],
    [  -1,   -1,   -1,   -1,   -1,   -1,  168,  169,  170,   -1,   -1,   -1,   -1,   -1,   -1],
    [  -1,   -1,   -1,   -1,   -1,   -1,   -1,   -1,   -1,   -1,   -1,   -1,   -1,   -1,   -1],
    [  -1,   -1,   -1,   -1,   -1,   -1,   -1,   -1,   -1,   -1,   -1,   -1,   -1,   -1,   -1],
    [  -1,   -1,   -1,   -1,   -1,   -1,   -1,   -1,   -1,   -1,   -1,   -1,   -1,   -1,   -1],
    [  -1,   -1,   -1,   -1,   -1,   -1,   -1,   -1,   -1,   -1,   -1,   -1,   -1,   -1,   -1],
    [  -1,   -1,  560,  265,   -1,   -1,   -1,   -1,   -1,  563,   -1,  163,  164,   -1,   -1],
    [  -1,   -1,   -1,   -1,   -1,   -1,   -1,   -1,   -1,   -1,   -1,   -1,   -1,   -1,   -1],
    [  -1,   -1,   -1,   -1,   -1,   -1,   -1,   -1,   -1,  558,   -1,   -1,   -1,   -1,   -1],
    [  -1,   -1,   -1,   -1,   -1,   -1,   -1,   -1,   -1,   -1,   -1,   -1,   -1,   -1,   -1],
    [  -1,   -1,   -1,   -1,   -1,   -1,   -1,   -1,   -1,   -1,   -1,   -1,   -1,   -1,   -1]
  ],
  "couche2": [
    [  -1,   -1,   -1,   -1,   -1,   -1,   -1,   -1,   -1,   -1,   -1,   -1,   -1,   -1,   -1],
    [  -1,   -1,   -1,   -1,   -1,   -1,   -1,   -1,   -1,   -1,   -1,   -1,   -1,   -1,   -1],
    [  -1,   -1,   -1,   -1,   -1,   -1,   -1,   -1,   -1,   -1,   -1,   -1,   -1,   -1,   -1],
    [  -1,   -1,   -1,   -1,   -1,   -1,   -1,   -1,   -1,   -1,   -1,   -1,   -1,   -1,   -1],
    [  -1,   -1,   -1,   -1,   -1,   -1,   -1,   -1,   -1,   -1,   -1,   -1,   -1,   -1,   -1],
    [  -1,   -1,   -1,   -1,   -1,   -1,   -1,   -1,   -1,   -1,   -1,   -1,   -1,   -1,   -1],
    [  -1,   -1,   -1,   -1,   -1,   -1,   -1,   -1,   -1,   -1,   -1,   -1,   -1,   -1,   -1],
    [  -1,   -1,   -1,  415,   -1,   -1,   -1,   -1,   -1,  418,   -1,   -1,   -1,   -1,   -1],
    [  -1,   -1,   -1,  451,   -1,   -1,   -1,   -1,   -1,  454,   -1,   -1,   -1,   -1,   -1],
    [  -1,   -1,   -1,  487,   -1,   -1,   -1,   -1,   -1,  490,   -1,   -1,   -1,   -1,   -1],
    [  -1,   -1,   -1,   -1,   -1,   -1,   -1,   -1,   -1,   -1,   -1,   -1,   -1,   -1,   -1],
    [  -1,   -1,   -1,   -1,   -1,   -1,   -1,   -1,   -1,   -1,   -1,   -1,   -1,   -1,   -1],
    [  -1,   -1,   -1,   -1,   -1,   -1,   -1,   -1,   -1,   -1,   -1,   -1,   -1,   -1,   -1],
    [  -1,   -1,   -1,   -1,   -1,   -1,   -1,   -1,   -1,   -1,   -1,   -1,   -1,   -1,   -1],
    [  -1,   -1,   -1,   -1,   -1,   -1,   -1,   -1,   -1,   -1,   -1,   -1,   -1,   -1,   -1]
  ]
}