 197  256  256  256  256  256  256  256  256  256  256  256  256  256  196 
 221  298  298  298  298  298  298  298  298  298  298  298  298  298  219 
 221  298  298  298  298  298  298  298  298  298  298  298  298  298  219 
 221  334  334  334  334  334  334  334  334  334  334  334  334  334  219 
 221  508  508  508  437  508  508  508  508  508  508  508  508  508  219 
 221  508  437  508  508  508  508  508  508  508  508  508  437  508  219 
 221  508  508  508  508  508  508  435  437  508  437  508  508  508  219 
 221  508  508  508  508  437  508  508  435  508  508  508  508  508  219 
 221  508  508  508  508  508  508  508  544  508  508  508  437  508  219 
 221  508  508  508  508  508  508  509  436  543  544  544  544  508  219 
 221  508  508  508  437  508  508  545  436  436  436  436  436  507  219 
 221  508  508  508  508  508  545  436  436  436  436  436  471  508  219 
 221  508  437  508  508  509  436  436  436  436  472  472  437  508  219 
 221  508  508  508  508  509  436  436  436  471  437  508  508  437  219 
 161  184  184  184  184  185  471  472  473  183  184  184  184  184  160 