 271  271  271  271  271  271  271  271  271  271  271  271  271  271  271  271  271  271  271  271  271  271  271  271  271  271  301  420  421  422  271  271  271  271  271  271  271  271  271  271  271  271  271  271  271  271  271  271  271  271 
 271  271  271  271  271  271  271  271  271  271  271  271  271  271  271  271  271  271  271  271  271  271   67  271  127  271  390  421  421  422  271  271  246  271  271  271  271  271  271  271  271  271  271  271  271  271  271  271  271  271 
 271  271  271  271  271  271  271  271  271  271  271  271  271  271  271  271  271  271  271  271  271  271  271  271  271  271  420  421  421  422  271  271  271  271  271  271  271  271  271  271  271  271  271  271  271  271  271  271  271  271 
 271  271  271  271  271  271  271  271  271  271  271  271  271  271  271  271  271  271  271  271  271  271  271  271  271  390  421  421  421  452  271  271  271  271  271  271  271  271  271  271  271  271  271  271  271  271  271  271  271  271 
 271  271  271  271  271  271  271  271  271  271  271  271  271  271  271  271  271  271  271  271  271  271  271  271  271  420  421  421  422  301  271  271  271  271  271  271  271  271  271  271  271  271  271  271  301  301  301  301  301  301 
 271  271  271  271  271  271  271  271  271  271  271  271  271  271  271  271  271  271  271  301  301  301  301  301  390  421  421  421  422  301  271  271  271  271  271  271  271  271  271  271  271  271  271  271  301  301  301  301  301  301 
 271  271  271  271  271  271  271  271  271  271  271  271  271  271  271  271  271  271  271  301  246  301  301  301  420  421  421  421  452  301  301  301  301  301  301  301  301  301  301  301  301  301  301  301  301  301  301  301  301  301 
 271  271  271  271  271  271  271  271  271  271  271  271  271  271  271  271   67  271  271  301  301  301  301  390  421  421  421  452  301  301  301  301  301  301   67  301  301  301  301  301  301  301  301  301  301  301  301  301  301  301 
 301  301  301  301  301  301  301  301  301  301  301  301  301  301  301  301  301  301  301  301  301  301  301  420  421  421  422  301  301  301  301  301  301  301  301  301  301  301  301  301  301  301  301  301  301  301  301  301  301  301 
 301  301  301  301  301  301  301  301  301  301  301  301  301  301  301  301  301  301  301  301  301  390  391  421  421  421  452  301  301  301  301  301  301  301  301  301  301  301  301  301  301  301  301  301  301  301  301  301  301  301 
 301  301  301  301  301  301  301  301  271  301  301  301  301  301  301  301  301  301  301  301  301  420  421  421  421  452  301  301  301  373  373  246  373  373  301  301  301  301  301  301  301  301  301  301  301  301  301  301  301  301 
 301  301  301  301  301  301  301  301  301  301  301  301  301  301  301  301  301  301  301  301  301  420  421  421  422  301  301  301  301  301  373  373  373  373  373  301  301  301  301  301  301  301  301  301  301  301  301  301  301  301 
 301  301  301  301  301  301  301  301  246  301  301  301  301  301  301  301  301  301  301  301  301  420  421  421  422  301  301  301  301  301  373  373  373  373  373  301  301  301  301  301  301  301  301  301  301  301  301  301  301  301 
 301  301  301  301  301  301  301  301  301  301  301  301  301  301  301  301  301  301  301  301  390  421  421  421  422  301  271  271  271  271  373  373  246  373  373  301  301   67  301  301  301  301  301  301  301  301  301  301  301  301 
 301  301  301  301  301  301  301  301   67  301  301  301  301  301  301  301  301  301  390  391  421  421  421  421  421  392  271  271  271  271  373  373  373  373  301  301  301  301  301  301  301  301  301  301  301  301  301  301  301  301 
 301  301  301  301  301  301  301  301  301  301  301  301  301  301  301  301  390  391  421  421  421  421  421  421  421  422  271  271  271  271  271  271  271  301  301  301  301  301  301  301  301  301  301  301  301  301  301  301  301  301 
  67  301  301  301  246  301  301  271  271  271  271  271  271  246  271  271  420  421  421  421  421  421  421  421  421  421  391  391  391  392  271  271  271  301  301  301  301  301  301  246  301  301  301  301  301  247  247  247  301  301 
 301  301  301  301  301  301  301  271  271  246  271  271  271  271  390  391  421  421  421  421  421  421  421  421  421  421  421  421  421  422  271  271  271  301  301  301  301  301  301  301  301  301  301  301  301  247  247  247  247  301 
 391  391  391  391  391  391  392  361  271  271  271  390  391  391  421  421  421  421  421  421  421  451  451  451  451  421  421  421  421  421  391  391  391  392  301  301  301  301  301  301  301  301  301  301  301  246  247  247  247  301 
 421  421  421  421  421  421  421  392  271  271  390  421  421  421  421  421  421  451  451  451  452  301  301  301  301  450  451  421  421  421  421  421  421  422  301  301  301  301  301  301  301  390  392  301  301  301  247  247  246  301 
 451  451  451  421  421  421  421  421  391  391  421  421  421  451  451  451  452  301  301  301  301  301  301  301  246  301  271  450  451  421  421  421  421  421  392  271   67  271  271  390  391  421  421  391  392  301  301  301  301  301 
 301  301  301  450  451  451  421  421  421  421  421  451  452  271  271  271  271  301  301  301  246  301  301  301  301  301  271  271  271  450  451  451  421  421  422  271  271  390  391  421  421  421  421  421  421  391  391  391  391  391 
 301  301  301  301  301  301  450  451  451  451  452  271  271  271  271  271  271  301  301  301  301  301  301  301  301  301  271  271  271  271  271  271  420  421  421  391  391  421  421  421  421  421  421  421  421  421  421  421  421  421 
 301  247  246  301  301  301  301  271  271  271  271  271  271  271  271  271  271  301  301  301  301  301  301  301  301  301  271  271  271  271  271  271  450  451  421  421  421  421  421  421  421  421  451  451  451  451  451  451  451  451 
  67  301  301  301  301  301  301  271  271  271  271  271  271  271  271  271  271  301  301  301  301  301  301  301  301  301  271  271  271  271  271  271  271  271  420  421  421  421  421  451  451  452  301  301  301  301  301  301  301  301 
 301  301  301  301  301  301  301  271  271  246  271  271  271  271  271  271  271  301  301  301  301  301  301  301  301  301  271  271  271  271  271  271  271  271  450  451  451  451  452  271  301  301  301  301  301  301  246  301  301  301 
 301  301  301  301  301  301  301  301  301  301  301  301  301  301  301  301  301  301  301  301  301  301  301  301  301  301  271  271  271  271  271  271  271  271  271  271  271  271  271  271  301  301  301  301  301  301  301  301  301  301 
 301  246  301  301  301  301  301  301  301  301  301  301  301  301  301  301  301  301  301  301  301  301  301  301  301  301  301  301  301  271  271  271  271  271  246  271  271  271  271  271  301   67  301  301  301  301  301  301  301  301 
 301  301  301  301  301  301  301   67  301  301  301  301  301  301  301  301  301  301  301  301  301  301  301  301  301  301  301  301  301  271  271  271  271  271  271  271  271  271  271  271  301  301  301  301  301  301  301  301   67  301 
 301  301  301  301  301  301  301  301  301  301  301  301  301  301  301  301  301  301  301  301  301  301  301  301  301  301  301  301  301  271  271  271  271  271  271  271  271  271  271  271  301  301  301  301  301  301  301  301  301  301 
 301  301  301  301  301  301  301  301  301  301  301  301  301  301  301  301  301  301  301  301  301  301  301  301  301  301  301  301  301  271  271  271  271  271  271  271  271  271  271  271  301  301  301  301  301  301  301  301  301  301 