{
  "largeur": 50,
  "hauteur": 31,
  "chipset": "chipset5c.png",
  "musique": "chapt1medfill.mp3",
  "couche0": [
    [ 271,  271,  271,  271,  271,  271,  271,  271,  271,  271,  271,  271,  271,  271,  271,  271,  271,  271,  271,  271,  271,  271,  271,  271,  271,  271,  301,  420,  421,  422,  271,  271,  271,  271,  271,  271,  271,  271,  271,  271,  271,  271,  271,  271,  271,  271,  271,  271,  271,  271],
    [ 271,  271,  271,  271,  271,  271,  271,  271,  271,  271,  271,  271,  271,  271,  271,  271,  271,  271,  271,  271,  271,  271,   67,  271,  127,  271,  390,  421,  421,  422,  271,  271,  246,  271,  271,  271,  271,  271,  271,  271,  271,  271,  271,  271,  271,  271,  271,  271,  271,  271],
    [ 271,  271,  271,  271,  271,  271,  271,  271,  271,  271,  271,  271,  271,  271,  271,  271,  271,  271,  271,  271,  271,  271,  271,  271,  271,  271,  420,  421,  421,  422,  271,  271,  271,  271,  271,  271,  271,  271,  271,  271,  271,  271,  271,  271,  271,  271,  271,  271,  271,  271],
    [ 271,  271,  271,  271,  271,  271,  271,  271,  271,  271,  271,  271,  271,  271,  271,  271,  271,  271,  271,  271,  271,  271,  271,  271,  271,  390,  421,  421,  421,  452,  271,  271,  271,  271,  271,  271,  271,  271,  271,  271,  271,  271,  271,  271,  271,  271,  271,  271,  271,  271],
    [ 271,  271,  271,  271,  271,  271,  271,  271,  271,  271,  271,  271,  271,  271,  271,  271,  271,  271,  271,  271,  271,  271,  271,  271,  271,  420,  421,  421,  422,  301,  271,  271,  271,  271,  271,  271,  271,  271,  271,  271,  271,  271,  271,  271,  301,  301,  301,  301,  301,  301],
    [ 271,  271,  271,  271,  271,  271,  271,  271,  271,  271,  271,  271,  271,  271,  271,  271,  271,  271,  271,  301,  301,  301,  301,  301,  390,  421,  421,  421,  422,  301,  271,  271,  271,  271,  271,  271,  271,  271,  271,  271,  271,  271,  271,  271,  301,  301,  301,  301,  301,  301],
    [ 271,  271,  271,  271,  271,  271,  271,  271,  271,  271,  271,  271,  271,  271,  271,  271,  271,  271,  271,  301,  246,  301,  301,  301,  420,  421,  421,  421,  452,  301,  301,  301,  301,  301,  301,  301,  301,  301,  301,  301,  301,  301,  301,  301,  301,  301,  301,  301,  301,  301],
    [ 271,  271,  271,  271,  271,  271,  271,  271,  271,  271,  271,  271,  271,  271,  271,  271,   67,  271,  271,  301,  301,  301,  301,  390,  421,  421,  421,  452,  301,  301,  301,  301,  301,  301,   67,  301,  301,  301,  301,  301,  301,  301,  301,  301,  301,  301,  301,  301,  301,  301],
    [ 301,  301,  301,  301,  301,  301,  301,  301,  301,  301,  301,  301,  301,  301,  301,  301,  301,  301,  301,  301,  301,  301,  301,  420,  421,  421,  422,  301,  301,  301,  301,  301,  301,  301,  301,  301,  301,  301,  301,  301,  301,  301,  301,  301,  301,  301,  301,  301,  301,  301],
    [ 301,  301,  301,  301,  301,  301,  301,  301,  301,  301,  301,  301,  301,  301,  301,  301,  301,  301,  301,  301,  301,  390,  391,  421,  421,  421,  452,  301,  301,  301,  301,  301,  301,  301,  301,  301,  301,  301,  301,  301,  301,  301,  301,  301,  301,  301,  301,  301,  301,  301],
    [ 301,  301,  301,  301,  301,  301,  301,  301,  271,  301,  301,  301,  301,  301,  301,  301,  301,  301,  301,  301,  301,  420,  421,  421,  421,  452,  301,  301,  301,  373,  373,  246,  373,  373,  301,  301,  301,  301,  301,  301,  301,  301,  301,  301,  301,  301,  301,  301,  301,  301],
    [ 301,  301,  301,  301,  301,  301,  301,  301,  301,  301,  301,  301,  301,  301,  301,  301,  301,  301,  301,  301,  301,  420,  421,  421,  422,  301,  301,  301,  301,  301,  373,  373,  373,  373,  373,  301,  301,  301,  301,  301,  301,  301,  301,  301,  301,  301,  301,  301,  301,  301],
    [ 301,  301,  301,  301,  301,  301,  301,  301,  246,  301,  301,  301,  301,  301,  301,  301,  301,  301,  301,  301,  301,  420,  421,  421,  422,  301,  301,  301,  301,  301,  373,  373,  373,  373,  373,  301,  301,  301,  301,  301,  301,  301,  301,  301,  301,  301,  301,  301,  301,  301],
    [ 301,  301,  301,  301,  301,  301,  301,  301,  301,  301,  301,  301,  301,  301,  301,  301,  301,  301,  301,  301,  390,  421,  421,  421,  422,  301,  271,  271,  271,  271,  373,  373,  246,  373,  373,  301,  301,   67,  301,  301,  301,  301,  301,  301,  301,  301,  301,  301,  301,  301],
    [ 301,  301,  301,  301,  301,  301,  301,  301,   67,  301,  301,  301,  301,  301,  301,  301,  301,  301,  390,  391,  421,  421,  421,  421,  421,  392,  271,  271,  271,  271,  373,  373,  373,  373,  301,  301,  301,  301,  301,  301,  301,  301,  301,  301,  301,  301,  301,  301,  301,  301],
    [ 301,  301,  301,  301,  301,  301,  301,  301,  301,  301,  301,  301,  301,  301,  301,  301,  390,  391,  421,  421,  421,  421,  421,  421,  421,  422,  271,  271,  271,  271,  271,  271,  271,  301,  301,  301,  301,  301,  301,  301,  301,  301,  301,  301,  301,  301,  301,  301,  301,  301],
    [  67,  301,  301,  301,  246,  301,  301,  271,  271,  271,  271,  271,  271,  246,  271,  271,  420,  421,  421,  421,  421,  421,  421,  421,  421,  421,  391,  391,  391,  392,  271,  271,  271,  301,  301,  301,  301,  301,  301,  246,  301,  301,  301,  301,  301,  247,  247,  247,  301,  301],
    [ 301,  301,  301,  301,  301,  301,  301,  271,  271,  246,  271,  271,  271,  271,  390,  391,  421,  421,  421,  421,  421,  421,  421,  421,  421,  421,  421,  421,  421,  422,  271,  271,  271,  301,  301,  301,  301,  301,  301,  301,  301,  301,  301,  301,  301,  247,  247,  247,  247,  301],
    [ 391,  391,  391,  391,  391,  391,  392,  361,  271,  271,  271,  390,  391,  391,  421,  421,  421,  421,  421,  421,  421,  451,  451,  451,  451,  421,  421,  421,  421,  421,  391,  391,  391,  392,  301,  301,  301,  301,  301,  301,  301,  301,  301,  301,  301,  246,  247,  247,  247,  301],
    [ 421,  421,  421,  421,  421,  421,  421,  392,  271,  271,  390,  421,  421,  421,  421,  421,  421,  451,  451,  451,  452,  301,  301,  301,  301,  450,  451,  421,  421,  421,  421,  421,  421,  422,  301,  301,  301,  301,  301,  301,  301,  390,  392,  301,  301,  301,  247,  247,  246,  301],
    [ 451,  451,  451,  421,  421,  421,  421,  421,  391,  391,  421,  421,  421,  451,  451,  451,  452,  301,  301,  301,  301,  301,  301,  301,  246,  301,  271,  450,  451,  421,  421,  421,  421,  421,  392,  271,   67,  271,  271,  390,  391,  421,  421,  391,  392,  301,  301,  301,  301,  301],
    [ 301,  301,  301,  450,  451,  451,  421,  421,  421,  421,  421,  451,  452,  271,  271,  271,  271,  301,  301,  301,  246,  301,  301,  301,  301,  301,  271,  271,  271,  450,  451,  451,  421,  421,  422,  271,  271,  390,  391,  421,  421,  421,  421,  421,  421,  391,  391,  391,  391,  391],
    [ 301,  301,  301,  301,  301,  301,  450,  451,  451,  451,  452,  271,  271,  271,  271,  271,  271,  301,  301,  301,  301,  301,  301,  301,  301,  301,  271,  271,  271,  271,  271,  271,  420,  421,  421,  391,  391,  421,  421,  421,  421,  421,  421,  421,  421,  421,  421,  421,  421,  421],
    [ 301,  247,  246,  301,  301,  301,  301,  271,  271,  271,  271,  271,  271,  271,  271,  271,  271,  301,  301,  301,  301,  301,  301,  301,  301,  301,  271,  271,  271,  271,  271,  271,  450,  451,  421,  421,  421,  421,  421,  421,  421,  421,  451,  451,  451,  451,  451,  451,  451,  451],
    [  67,  301,  301,  301,  301,  301,  301,  271,  271,  271,  271,  271,  271,  271,  271,  271,  271,  301,  301,  301,  301,  301,  301,  301,  301,  301,  271,  271,  271,  271,  271,  271,  271,  271,  420,  421,  421,  421,  421,  451,  451,  452,  301,  301,  301,  301,  301,  301,  301,  301],
    [ 301,  301,  301,  301,  301,  301,  301,  271,  271,  246,  271,  271,  271,  271,  271,  271,  271,  301,  301,  301,  301,  301,  301,  301,  301,  301,  271,  271,  271,  271,  271,  271,  271,  271,  450,  451,  451,  451,  452,  271,  301,  301,  301,  301,  301,  301,  246,  301,  301,  301],
    [ 301,  301,  301,  301,  301,  301,  301,  301,  301,  301,  301,  301,  301,  301,  301,  301,  301,  301,  301,  301,  301,  301,  301,  301,  301,  301,  271,  271,  271,  271,  271,  271,  271,  271,  271,  271,  271,  271,  271,  271,  301,  301,  301,  301,  301,  301,  301,  301,  301,  301],
    [ 301,  246,  301,  301,  301,  301,  301,  301,  301,  301,  301,  301,  301,  301,  301,  301,  301,  301,  301,  301,  301,  301,  301,  301,  301,  301,  301,  301,  301,  271,  271,  271,  271,  271,  246,  271,  271,  271,  271,  271,  301,   67,  301,  301,  301,  301,  301,  301,  301,  301],
    [ 301,  301,  301,  301,  301,  301,  301,   67,  301,  301,  301,  301,  301,  301,  301,  301,  301,  301,  301,  301,  301,  301,  301,  301,  301,  301,  301,  301,  301,  271,  271,  271,  271,  271,  271,  271,  271,  271,  271,  271,  301,  301,  301,  301,  301,  301,  301,  301,   67,  301],
    [ 301,  301,  301,  301,  301,  301,  301,  301,  301,  301,  301,  301,  301,  301,  301,  301,  301,  301,  301,  301,  301,  301,  301,  301,  301,  301,  301,  301,  301,  271,  271,  271,  271,  271,  271,  271,  271,  271,  271,  271,  301,  301,  301,  301,  301,  301,  301,  301,  301,  301],
    [ 301,  301,  301,  301,  301,  301,  301,  301,  301,  301,  301,  301,  301,  301,  301,  301,  301,  301,  301,  301,  301,  301,  301,  301,  301,  301,  301,  301,  301,  271,  271,  271,  271,  271,  271,  271,  271,  271,  271,  271,  301,  301,  301,  301,  301,  301,  301,  301,  301,  301]
  ],
  "couche1": [
    [ 233,  233,  233,  233,  233,  233,  233,  233,  233,  233,  233,  233,  233,  233,  233,  233,  233,   -1,   -1,   -1,   -1,   -1,   -1,   -1,   -1,   -1,   -1,   -1,   -1,   -1,   -1,   -1,   -1,   -1,   -1,  232,  232,  232,  232,  233,  233,  233,  233,  233,  233,  233,  233,  233,  233,  233],
    [ 233,  233,  233,  233,  233,  233,  233,  233,  233,  233,  233,  233,  233,  233,  233,  233,  233,   -1,   -1,   -1,   -1,   -1,   -1,   -1,   -1,   -1,   -1,   -1,   -1,   -1,   -1,   -1,   -1,   -1,   -1,  232,  232,  232,  232,  233,  233,  233,  233,  233,  233,  233,  233,  233,  233,  233],
    [ 233,  233,  233,  233,  233,  233,  233,  233,  233,  233,  233,  233,  233,  233,  233,  233,  233,   -1,   -1,   -1,   -1,   -1,   -1,   -1,   -1,   -1,   -1,   -1,   -1,   -1,   -1,   -1,   -1,   -1,   -1,  232,  232,  232,  232,  233,  233,  233,  233,  233,  233,  233,  233,  233,  233,  233],
    [ 233,  233,  233,  233,  233,  233,  233,  233,  233,  233,  233,  233,  233,  233,  233,  233,  233,   -1,   -1,   -1,   -1,   -1,   -1,   -1,   -1,   -1,   -1,   -1,   -1,   -1,   -1,   -1,   -1,   -1,   -1,  232,  232,  232,  232,  233,  233,  233,  233,  233,  233,  233,  233,  233,  233,  233],
    [ 233,  233,  233,  233,  233,  233,  233,  233,  233,  233,  233,  233,  233,  233,  233,  233,  233,   -1,   -1,   -1,   -1,   -1,   -1,   -1,   -1,   -1,   -1,   -1,   -1,   -1,   -1,   -1,   -1,   -1,   -1,  232,  232,  232,  232,  232,  232,  233,  233,  233,  233,  233,  233,  233,  233,  233],
    [ 233,  233,  233,  233,  233,  233,  233,  233,  233,  233,  233,  233,  233,   -1,   -1,   -1,   -1,   -1,   -1,   -1,   -1,   -1,   -1,   -1,   -1,   -1,   -1,   -1,   -1,   -1,   -1,   -1,   -1,   -1,   -1,   -1,   -1,   -1,  232,  232,  232,  233,  233,  233,  233,  233,  233,  233,  233,  233],
    [ 233,  233,  233,  233,  233,  233,  233,  233,  233,  233,  233,  233,  233,   -1,   -1,   -1,   -1,   -1,   -1,   -1,   -1,   -1,   -1,   -1,   -1,   -1,   -1,   -1,   -1,   -1,   -1,   -1,   -1,   -1,   -1,   -1,   -1,   -1,  232,  232,  232,  233,  233,  233,  233,  233,  233,  233,  233,  233],
    [ 233,  233,  233,  233,  233,  233,  233,  233,  233,  233,   -1,   -1,   -1,   -1,   -1,   -1,   -1,   -1,   -1,   -1,   -1,   -1,   -1,   -1,   -1,   -1,   -1,   -1,   -1,   -1,   -1,   -1,   -1,   -1,   -1,   -1,   -1,   -1,  232,  232,  232,  232,  232,  232,  232,  233,  233,  233,  233,  233],
    [ 233,  233,  233,  233,  233,  233,   -1,   -1,   -1,   -1,   -1,   -1,   -1,   -1,   -1,   -1,   -1,   -1,   -1,   -1,   -1,   -1,   -1,   -1,   -1,   -1,   -1,   -1,   -1,   -1,   -1,   -1,   -1,   -1,   -1,   -1,   -1,   -1,  232,  232,  232,  233,  233,  232,  232,  232,  232,  232,  232,  232],
    [ 233,  233,  233,  233,   -1,   -1,   -1,   -1,   -1,   -1,   -1,   -1,   -1,   -1,   -1,   -1,   -1,   -1,   -1,   -1,   -1,   -1,   -1,   -1,   -1,   -1,   -1,   -1,   -1,   -1,   -1,   -1,   -1,   -1,   -1,   -1,   -1,   -1,   -1,   -1,   -1,   -1,   -1,  232,  232,  232,  232,  232,  232,  232],
    [ 233,  233,  233,  233,   -1,   -1,   -1,   -1,   -1,   -1,   -1,   -1,   -1,   -1,   -1,   -1,   -1,   -1,   -1,  446,   -1,   -1,   -1,   -1,   -1,   -1,   -1,   -1,   -1,   -1,   -1,   -1,   -1,   -1,   -1,   -1,   -1,   -1,   -1,   -1,   -1,   -1,   -1,  232,  232,  232,  232,  232,  232,  232],
    [ 233,  233,  233,  233,   -1,   -1,   -1,   -1,   -1,   -1,   -1,   -1,   -1,   -1,   -1,   -1,   -1,   -1,   -1,   -1,   -1,   -1,   -1,   -1,   -1,   -1,   -1,   -1,   -1,   -1,   -1,   -1,   -1,   -1,   -1,   -1,   -1,   -1,   -1,   -1,   -1,   -1,   -1,  232,  232,  232,  232,  232,  232,  232],
    [ 233,  233,  233,  233,   -1,   -1,   -1,   -1,   -1,   -1,   -1,   -1,  446,   -1,   -1,   -1,   -1,   -1,   -1,   -1,   -1,   -1,   -1,   -1,   -1,   -1,   -1,   -1,   -1,   -1,   -1,   -1,   -1,   -1,   -1,   -1,   -1,   -1,   -1,   -1,   -1,   -1,   -1,  232,  232,  232,  232,   -1,   -1,   -1],
    [ 233,  233,  233,  233,   -1,   -1,   -1,   -1,   -1,   -1,   -1,   -1,   -1,   -1,   -1,   -1,   -1,   -1,   -1,   -1,   -1,   -1,   -1,   -1,   -1,   -1,   -1,   -1,   -1,   -1,   -1,   -1,   -1,   -1,   -1,   -1,   -1,   -1,   -1,   -1,   -1,   -1,   -1,   -1,   -1,   -1,   -1,   -1,   -1,   -1],
    [  -1,   -1,   -1,   -1,   -1,   -1,   -1,   -1,   -1,   -1,   -1,   -1,   -1,   -1,   -1,   -1,   -1,   -1,   -1,   -1,   -1,   -1,   -1,   -1,   -1,   -1,   -1,   -1,   -1,   -1,   -1,   -1,   -1,   -1,   -1,   -1,   -1,   -1,   -1,   -1,   -1,   -1,   -1,   -1,   -1,   -1,   -1,   -1,   -1,   -1],
    [  -1,   -1,   -1,   -1,   -1,   -1,   -1,   -1,   -1,   -1,   -1,   -1,   -1,   -1,   -1,   -1,   -1,   -1,   -1,   -1,   -1,   -1,   -1,   -1,   -1,   -1,   -1,   -1,   -1,   -1,   -1,   -1,   -1,   -1,   -1,   -1,   -1,   -1,   -1,   -1,   -1,   -1,   -1,   -1,   -1,   -1,   -1,   -1,   -1,   -1],
    [  -1,   -1,   -1,   -1,   -1,   -1,   -1,   -1,   -1,   -1,   -1,   -1,   -1,   -1,   -1,   -1,   -1,   -1,   -1,   -1,   -1,   -1,  414,   -1,   -1,   -1,   -1,   -1,   -1,   -1,   -1,   -1,   -1,   -1,   -1,   -1,   -1,   -1,   -1,   -1,   -1,   -1,   -1,   -1,   -1,   -1,   -1,   -1,   -1,   -1],
    [  -1,   -1,   -1,   -1,   -1,   -1,   -1,   -1,   -1,   -1,   -1,   -1,   -1,   -1,   -1,   -1,   -1,   -1,   -1,   -1,   -1,   -1,   -1,   -1,   -1,   -1,   -1,   -1,   -1,   -1,   -1,   -1,   -1,  446,   -1,   -1,   -1,   -1,   -1,   -1,   -1,   -1,   -1,   -1,   -1,   -1,   -1,   -1,   -1,   -1],
    [  -1,   -1,   -1,   -1,   -1,   -1,   -1,   -1,   -1,   -1,   -1,   -1,   -1,   -1,   -1,   -1,   -1,   -1,   -1,   -1,   -1,   -1,   -1,   -1,   -1,   -1,   -1,   -1,   -1,   -1,   -1,   -1,   -1,   -1,   -1,   -1,   -1,   -1,   -1,   -1,   -1,   -1,   -1,   -1,   -1,   -1,   -1,   -1,   -1,   -1],
    [  -1,   -1,   -1,   -1,   -1,   -1,   -1,   -1,   -1,   -1,   -1,   -1,   -1,   -1,   -1,   -1,   -1,   -1,   -1,   -1,   -1,   -1,   -1,   -1,   -1,   -1,   -1,   -1,   -1,   -1,   -1,   -1,   -1,   -1,   -1,   -1,   -1,   -1,   -1,   -1,   -1,   -1,   -1,   -1,   -1,   -1,   -1,   -1,   -1,   -1],
    [  -1,   -1,   -1,   -1,   -1,   -1,   -1,   -1,   -1,   -1,   -1,   -1,   -1,   -1,   -1,   -1,   -1,   -1,   -1,   -1,   -1,   -1,   -1,   -1,   -1,   -1,   -1,   -1,   -1,   -1,   -1,   -1,   -1,   -1,   -1,   -1,   -1,   -1,   -1,   -1,   -1,   -1,   -1,   -1,   -1,   -1,   -1,   -1,   -1,   -1],
    [  -1,   -1,   -1,   -1,   -1,   -1,   -1,   -1,   -1,   -1,   -1,   -1,   -1,   -1,   -1,   -1,   -1,   -1,   -1,   -1,   -1,   -1,   -1,   -1,   -1,   -1,   -1,   -1,   -1,   -1,   -1,   -1,   -1,   -1,   -1,   -1,   -1,   -1,   -1,   -1,   -1,   -1,   -1,   -1,   -1,   -1,   -1,   -1,   -1,   -1],
    [  -1,   -1,   -1,   -1,   -1,   -1,   -1,   -1,   -1,   -1,   -1,   -1,   -1,   -1,   -1,   -1,   -1,   -1,   -1,   -1,   -1,   -1,   -1,   -1,   -1,   -1,   -1,   -1,   -1,   -1,   -1,   -1,   -1,   -1,   -1,   -1,   -1,   -1,   -1,   -1,   -1,   -1,   -1,   -1,   -1,   -1,   -1,   -1,   -1,   -1],
    [  -1,   -1,   -1,   -1,   -1,   -1,   -1,   -1,   -1,   -1,   -1,   -1,   -1,   -1,   -1,  446,   -1,   -1,   -1,   -1,   -1,   -1,  233,  233,  233,   -1,   -1,   -1,   -1,   -1,   -1,   -1,   -1,   -1,   -1,   -1,   -1,   -1,   -1,   -1,   -1,   -1,   -1,   -1,   -1,   -1,   -1,   -1,   -1,   -1],
    [  -1,   -1,   -1,   -1,   -1,   -1,   -1,   -1,   -1,   -1,   -1,   -1,   -1,   -1,   -1,   -1,   -1,   -1,   -1,   -1,   -1,  233,  233,  233,  233,   -1,   -1,   -1,   -1,   -1,   -1,   -1,   -1,   -1,   -1,   -1,   -1,   -1,   -1,   -1,   -1,   -1,   -1,   -1,   -1,   -1,   -1,   -1,   -1,   -1],
    [  -1,   -1,   -1,   -1,  446,   -1,   -1,   -1,   -1,   -1,   -1,   -1,   -1,   -1,   -1,   -1,   -1,   -1,   -1,   -1,  233,  233,  233,  233,  233,  233,  233,   -1,   -1,   -1,   -1,   -1,   -1,   -1,   -1,   -1,   -1,   -1,   -1,   -1,   -1,   -1,   -1,   -1,   -1,   -1,   -1,   -1,   -1,   -1],
    [  -1,   -1,   -1,   -1,   -1,   -1,   -1,   -1,   -1,   -1,   -1,   -1,   -1,   -1,   -1,   -1,   -1,   -1,  233,  233,  233,  233,  233,  233,  233,  233,  233,  233,   -1,   -1,   -1,   -1,   -1,   -1,   -1,   -1,   -1,   -1,   -1,   -1,   -1,   -1,   -1,   -1,   -1,   -1,   -1,   -1,   -1,   -1],
    [  -1,   -1,   -1,   -1,   -1,   -1,   -1,   -1,   -1,   -1,   -1,   -1,   -1,   -1,  233,  233,  233,  233,  233,  233,  233,  233,  233,  233,  233,  233,  233,  233,  233,  233,   -1,   -1,   -1,   -1,   -1,   -1,   -1,  294,  295,  296,  297,   -1,   -1,   -1,  446,   -1,   -1,   -1,   -1,   -1],
    [  -1,   -1,   -1,   -1,   -1,   -1,   -1,   -1,   -1,   -1,   -1,  233,  233,  233,  233,  233,  233,  233,  233,  233,  233,  233,  233,  233,  233,  233,  233,  233,  233,  233,   -1,   -1,   -1,   -1,   -1,   -1,   -1,   -1,   -1,   -1,   -1,   -1,   -1,   -1,   -1,   -1,   -1,   -1,   -1,   -1],
    [  -1,   -1,   -1,   -1,   -1,   -1,   -1,   -1,   -1,   -1,   -1,  233,  233,  233,  233,  233,  233,  233,  233,  233,  233,  233,  233,  233,  233,  233,  233,  233,  233,  233,  233,  233,   -1,   -1,   -1,   -1,   -1,   -1,   -1,   -1,   -1,   -1,   -1,   -1,   -1,   -1,   -1,   -1,   -1,   -1],
    [  -1,   -1,   -1,   -1,   -1,   -1,   -1,   -1,   -1,   -1,   -1,  233,  233,  233,  233,  233,  233,  233,  233,  233,  233,  233,  233,  233,  233,  233,  233,  233,  233,  233,  233,  233,   -1,   -1,   -1,   -1,   -1,   -1,   -1,   -1,   -1,   -1,   -1,   -1,   -1,  294,  295,  296,  297,   -1]
  ],
  "couche2": [
    [  -1,   -1,   -1,   -1,   -1,   -1,   -1,   -1,   -1,   -1,   -1,   -1,   -1,   -1,   -1,   -1,   -1,   -1,   -1,   -1,   -1,   -1,   -1,   -1,   -1,   -1,   -1,   -1,   -1,   -1,   -1,   -1,   -1,   -1,   -1,   -1,   -1,   -1,   -1,   -1,   -1,   -1,   -1,   -1,   -1,   -1,   -1,   -1,   -1,   -1],
    [  -1,   -1,   -1,   -1,   -1,   -1,   -1,   -1,   -1,   -1,   -1,   -1,   -1,   -1,   -1,   -1,   -1,   -1,   -1,   -1,   -1,   -1,   -1,   -1,   -1,   -1,   -1,   -1,   -1,   -1,   -1,   -1,   -1,   -1,   -1,   -1,   -1,   -1,   -1,   -1,   -1,   -1,   -1,   -1,   -1,   -1,   -1,   -1,   -1,   -1],
    [  -1,   -1,   -1,   -1,   -1,   -1,   -1,   -1,   -1,   -1,   -1,   -1,   -1,   -1,   -1,   -1,   -1,   -1,   -1,   -1,   -1,   -1,   -1,   -1,   -1,   -1,   -1,   -1,   -1,   -1,   -1,   -1,   -1,   -1,   -1,   -1,   -1,   -1,   -1,   -1,   -1,   -1,   -1,   -1,   -1,   -1,   -1,   -1,   -1,   -1],
    [  -1,   -1,   -1,   -1,   -1,   -1,   -1,   -1,   -1,   -1,   -1,   -1,   -1,   -1,   -1,   -1,   -1,   -1,   -1,   -1,   -1,   -1,   -1,   -1,   -1,   -1,   -1,   -1,   -1,   -1,   -1,   -1,   -1,   -1,   -1,   -1,   -1,   -1,   -1,   -1,   -1,   -1,   -1,   -1,   -1,   -1,   -1,   -1,   -1,   -1],
    [  -1,   -1,   -1,   -1,   -1,   -1,   -1,   -1,   -1,   -1,   -1,   -1,   -1,   -1,   -1,   -1,   -1,   -1,   -1,   -1,   -1,   -1,   -1,   -1,   -1,   -1,   -1,   -1,   -1,   -1,   -1,   -1,   -1,   -1,   -1,   -1,   -1,   -1,   -1,   -1,   -1,   -1,   -1,   -1,   -1,   -1,   -1,   -1,   -1,   -1],
    [  -1,   -1,   -1,   -1,   -1,   -1,   -1,   -1,   -1,   -1,   -1,   -1,   -1,   -1,   -1,   -1,   -1,   -1,   -1,   -1,   -1,   -1,   -1,   -1,   -1,   -1,   -1,   -1,   -1,   -1,   -1,   -1,   -1,   -1,   -1,   -1,   -1,   -1,   -1,   -1,   -1,   -1,   -1,   -1,   -1,   -1,   -1,   -1,   -1,   -1],
    [  -1,   -1,   -1,   -1,   -1,   -1,   -1,   -1,   -1,   -1,   -1,   -1,   -1,   -1,   -1,   -1,   -1,   -1,   -1,   -1,   -1,   -1,   -1,   -1,   -1,   -1,   -1,   -1,   -1,   -1,   -1,   -1,   -1,   -1,   -1,   -1,   -1,   -1,   -1,   -1,   -1,   -1,   -1,   -1,   -1,   -1,   -1,   -1,   -1,   -1],
    [  -1,   -1,   -1,   -1,   -1,   -1,   -1,   -1,   -1,   -1,   -1,   -1,   -1,   -1,   -1,   -1,   -1,   -1,   -1,   -1,   -1,   -1,   -1,   -1,   -1,   -1,   -1,   -1,   -1,   -1,   -1,   -1,   -1,   -1,   -1,   -1,   -1,   -1,   -1,   -1,   -1,   -1,   -1,   -1,   -1,   -1,   -1,   -1,   -1,   -1],
    [  -1,   -1,   -1,   -1,   -1,   -1,   -1,   -1,   -1,   -1,   -1,   -1,   -1,   -1,   -1,   -1,   -1,   -1,   -1,   -1,   -1,   -1,   -1,   -1,   -1,   -1,   -1,   -1,   -1,   -1,   -1,   -1,   -1,   -1,   -1,   -1,   -1,   -1,   -1,   -1,   -1,   -1,   -1,   -1,   -1,   -1,   -1,   -1,   -1,   -1],
    [  -1,   -1,   -1,   -1,   -1,   -1,   -1,   -1,   -1,   -1,   -1,   -1,   -1,   -1,   -1,   -1,   -1,   -1,   -1,   -1,   -1,   -1,   -1,   -1,   -1,   -1,   -1,   -1,   -1,   -1,   -1,   -1,   -1,   -1,   -1,   -1,   -1,   -1,   -1,   -1,   -1,   -1,   -1,   -1,   -1,   -1,   -1,   -1,   -1,   -1],
    [  -1,   -1,   -1,   -1,   -1,   -1,   -1,   -1,   -1,   -1,   -1,   -1,   -1,   -1,   -1,   -1,   -1,   -1,   -1,   -1,   -1,   -1,   -1,   -1,   -1,   -1,   -1,   -1,   -1,   -1,   -1,   -1,   -1,   -1,   -1,   -1,   -1,   -1,   -1,   -1,   -1,   -1,   -1,   -1,   -1,   -1,   -1,   -1,   -1,   -1],
    [  -1,   -1,   -1,   -1,   -1,   -1,   -1,   -1,   -1,   -1,   -1,   -1,   -1,   -1,   -1,   -1,   -1,   -1,   -1,   -1,   -1,   -1,   -1,   -1,   -1,   -1,   -1,   -1,   -1,   -1,   -1,   -1,   -1,   -1,   -1,   -1,   -1,   -1,   -1,   -1,   -1,   -1,   -1,   -1,   -1,   -1,   -1,   -1,   -1,   -1],
    [  -1,   -1,   -1,   -1,   -1,   -1,   -1,   -1,   -1,   -1,   -1,   -1,   -1,   -1,   -1,   -1,   -1,   -1,   -1,   -1,   -1,   -1,   -1,   -1,   -1,   -1,   -1,   -1,   -1,   -1,   -1,   -1,   -1,   -1,   -1,   -1,   -1,   -1,   -1,   -1,   -1,   -1,   -1,   -1,   -1,   -1,   -1,   -1,   -1,   -1],
    [  -1,   -1,   -1,   -1,   -1,   -1,   -1,   -1,   -1,   -1,   -1,   -1,   -1,   -1,   -1,   -1,   -1,   -1,   -1,   -1,   -1,   -1,   -1,   -1,   -1,   -1,   -1,   -1,   -1,   -1,   -1,   -1,   -1,   -1,   -1,   -1,   -1,   -1,   -1,   -1,   -1,   -1,   -1,   -1,   -1,   -1,   -1,   -1,   -1,   -1],
    [  -1,   -1,   -1,   -1,   -1,   -1,   -1,   -1,   -1,   -1,   -1,   -1,   -1,   -1,   -1,   -1,   -1,   -1,   -1,   -1,   -1,   -1,   -1,   -1,   -1,   -1,   -1,   -1,   -1,   -1,   -1,   -1,   -1,   -1,   -1,   -1,   -1,   -1,   -1,   -1,   -1,   -1,   -1,   -1,   -1,   -1,   -1,   -1,   -1,   -1],
    [  -1,   -1,   -1,   -1,   -1,   -1,   -1,   -1,   -1,   -1,   -1,   -1,   -1,   -1,   -1,   -1,   -1,   -1,   -1,   -1,   -1,   -1,   -1,   -1,   -1,   -1,   -1,   -1,   -1,   -1,   -1,   -1,   -1,   -1,   -1,   -1,   -1,   -1,   -1,   -1,   -1,   -1,   -1,   -1,   -1,   -1,   -1,   -1,   -1,   -1],
    [  -1,   -1,   -1,   -1,   -1,   -1,   -1,   -1,   -1,   -1,   -1,   -1,   -1,   -1,   -1,   -1,   -1,   -1,   -1,   -1,   -1,   -1,   -1,   -1,   -1,   -1,   -1,   -1,   -1,   -1,   -1,   -1,   -1,   -1,   -1,   -1,   -1,   -1,   -1,   -1,   -1,   -1,   -1,   -1,   -1,   -1,   -1,   -1,   -1,   -1],
    [  -1,   -1,   -1,   -1,   -1,   -1,   -1,   -1,   -1,   -1,   -1,   -1,   -1,   -1,   -1,   -1,   -1,   -1,   -1,   -1,   -1,   -1,   -1,   -1,   -1,   -1,   -1,   -1,   -1,   -1,   -1,   -1,   -1,   -1,   -1,   -1,   -1,   -1,   -1,   -1,   -1,   -1,   -1,   -1,   -1,   -1,   -1,   -1,   -1,   -1],
    [  -1,   -1,   -1,   -1,   -1,   -1,   -1,   -1,   -1,   -1,   -1,   -1,   -1,   -1,   -1,   -1,   -1,   -1,   -1,   -1,   -1,   -1,   -1,   -1,   -1,   -1,   -1,   -1,   -1,   -1,   -1,   -1,   -1,   -1,   -1,   -1,   -1,   -1,   -1,   -1,   -1,   -1,   -1,   -1,   -1,   -1,   -1,   -1,   -1,   -1],
    [  -1,   -1,   -1,   -1,   -1,   -1,   -1,   -1,   -1,   -1,   -1,   -1,   -1,   -1,   -1,   -1,   -1,   -1,   -1,   -1,   -1,   -1,   -1,   -1,   -1,   -1,   -1,   -1,   -1,   -1,   -1,   -1,   -1,   -1,   -1,   -1,   -1,   -1,   -1,   -1,   -1,   -1,   -1,   -1,   -1,   -1,   -1,   -1,   -1,   -1],
    [  -1,   -1,   -1,   -1,   -1,   -1,   -1,   -1,   -1,   -1,   -1,   -1,   -1,   -1,   -1,   -1,   -1,   -1,   -1,   -1,   -1,   -1,   -1,   -1,   -1,   -1,   -1,   -1,   -1,   -1,   -1,   -1,   -1,   -1,   -1,   -1,   -1,   -1,   -1,   -1,   -1,   -1,   -1,   -1,   -1,   -1,   -1,   -1,   -1,   -1],
    [  -1,   -1,   -1,   -1,   -1,   -1,   -1,   -1,   -1,   -1,   -1,   -1,   -1,   -1,   -1,   -1,   -1,   -1,   -1,   -1,   -1,   -1,   -1,   -1,   -1,   -1,   -1,   -1,   -1,   -1,   -1,   -1,   -1,   -1,   -1,   -1,   -1,   -1,   -1,   -1,   -1,   -1,   -1,   -1,   -1,   -1,   -1,   -1,   -1,   -1],
    [  -1,   -1,   -1,   -1,   -1,   -1,   -1,   -1,   -1,   -1,   -1,   -1,   -1,   -1,   -1,   -1,   -1,   -1,   -1,   -1,   -1,   -1,   -1,   -1,   -1,   -1,   -1,   -1,   -1,   -1,   -1,   -1,   -1,   -1,   -1,   -1,   -1,   -1,   -1,   -1,   -1,   -1,   -1,   -1,   -1,   -1,   -1,   -1,   -1,   -1],
    [  -1,   -1,   -1,   -1,   -1,   -1,   -1,   -1,   -1,   -1,   -1,   -1,   -1,   -1,   -1,   -1,   -1,   -1,   -1,   -1,   -1,   -1,   -1,   -1,   -1,   -1,   -1,   -1,   -1,   -1,   -1,   -1,   -1,   -1,   -1,   -1,   -1,  174,  175,  176,  177,   -1,   -1,   -1,   -1,   -1,   -1,   -1,   -1,   -1],
    [  -1,   -1,   -1,   -1,   -1,   -1,   -1,   -1,   -1,   -1,   -1,   -1,   -1,   -1,   -1,   -1,   -1,   -1,   -1,   -1,   -1,   -1,   -1,   -1,   -1,   -1,   -1,   -1,   -1,   -1,   -1,   -1,   -1,   -1,   -1,   -1,   -1,  204,  205,  206,  207,   -1,   -1,   -1,   -1,   -1,   -1,   -1,   -1,   -1],
    [  -1,   -1,   -1,   -1,   -1,   -1,   -1,   -1,   -1,   -1,   -1,   -1,   -1,   -1,   -1,   -1,   -1,   -1,   -1,   -1,   -1,   -1,   -1,   -1,   -1,   -1,   -1,   -1,   -1,   -1,   -1,   -1,   -1,   -1,   -1,   -1,   -1,  234,  235,  236,  237,   -1,   -1,   -1,   -1,   -1,   -1,   -1,   -1,   -1],
    [  -1,   -1,   -1,   -1,   -1,   -1,   -1,   -1,   -1,   -1,   -1,   -1,   -1,   -1,   -1,   -1,   -1,   -1,   -1,   -1,   -1,   -1,   -1,   -1,   -1,   -1,   -1,   -1,   -1,   -1,   -1,   -1,   -1,   -1,   -1,   -1,   -1,  264,  265,  266,  267,   -1,   -1,   -1,   -1,  174,  175,  176,  177,   -1],
    [  -1,   -1,   -1,   -1,   -1,   -1,   -1,   -1,   -1,   -1,   -1,   -1,   -1,   -1,   -1,   -1,   -1,   -1,   -1,   -1,   -1,   -1,   -1,   -1,   -1,   -1,   -1,   -1,   -1,   -1,   -1,   -1,   -1,   -1,   -1,   -1,   -1,   -1,   -1,   -1,   -1,   -1,   -1,   -1,   -1,  204,  205,  206,  207,   -1],
    [  -1,   -1,   -1,   -1,   -1,   -1,   -1,   -1,   -1,   -1,   -1,   -1,   -1,   -1,   -1,   -1,   -1,   -1,   -1,   -1,   -1,   -1,   -1,   -1,   -1,   -1,   -1,   -1,   -1,   -1,   -1,   -1,   -1,   -1,   -1,   -1,   -1,   -1,   -1,   -1,   -1,   -1,   -1,   -1,   -1,  234,  235,  236,  237,   -1],
    [  -1,   -1,   -1,   -1,   -1,   -1,   -1,   -1,   -1,   -1,   -1,   -1,   -1,   -1,   -1,   -1,   -1,   -1,   -1,   -1,   -1,   -1,   -1,   -1,   -1,   -1,   -1,   -1,   -1,   -1,   -1,   -1,   -1,   -1,   -1,   -1,   -1,   -1,   -1,   -1,   -1,   -1,   -1,   -1,   -1,  264,  265,  266,  267,   -1],
    [  -1,   -1,   -1,   -1,   -1,   -1,   -1,   -1,   -1,   -1,   -1,   -1,   -1,   -1,   -1,   -1,   -1,   -1,   -1,   -1,   -1,   -1,   -1,   -1,   -1,   -1,   -1,   -1,   -1,   -1,   -1,   -1,   -1,   -1,   -1,   -1,   -1,   -1,   -1,   -1,   -1,   -1,   -1,   -1,   -1,   -1,   -1,   -1,   -1,   -1]
  ]
}