 805  805  805  805  805  805  805  805  805  805  805  805  805  805  805  805 1005  939  939  939  939  939  940  805  805  805  805  805  805  805  805  805  805  805  805  805  805  805  805  805  808  808  808  808  874  942  942  417  485  686  615  683  683  683  683  683  683  683  683  683  683  683  683  683  683  683  683  683  683  683 
 805  805  677  805  805  805  805  805  805  805  805  805  805  805  805  805  805 1005  939  939  939  939  940  805  805  805  805  805  805  805  805  805  805  805  805  805  805  805  805  805  808  808  808  874  942  942  942  484  485  615  281  683  683  683  683  683  683  683  683  683  683  683  683  683  683  683  683  683  683  683 
 805  805  805  805  805  805  805  805  805  805  805  805  805  805  805  805  805  805 1005  939  939  939  940  805  805  805  805  805  805  805  805  805  805  805  805  805  805  805  805  808  808  808  874  942  942  485  485  484  485  682  683  683  683  683  683  683  683  683  683  683  683  683  683  683  683  683  683  683  683  683 
 805  805  805  805  805  805  805  805  805  805  805  805  805  807  805  805  805  805  805  938  939  939  939  873  805  805  805  805  805  805  805  805  805  805  805  805  274  805  805  808  808  941  942  942  162  162  162  484  485  682  683  683  683  683  683  683  683  683  683  683  683  683  683  683  683  683  683  683  683  683 
 805  805  805  805  805  805  805  805  805  805  805  805  805  805  805  274  805  805  805  938  939  939  939  939  873  805  805  805  805  805  805  805  805  805  805  805  805  805  805  808  808  941  942  942  942  162  162  484  485  682  683  683  683  683  683  683  683  683  683  683  683  683  683  683  683  683  683  683  683  683 
 805  805  805  805  805  805  805  805  805  805  805  805  805  805  805  805  805  805  871  939  939  939  939  939  939  872  872  872  873  804  806  806  804  805  805  805  805  805  805  808  808 1008  942  942  942  162  417  485  485  682  683  683  683  683  683  683  683  683  683  683  683  683  683  683  683  683  683  683  683  683 
 805  805  805  805  805  805  805  805  805  805  805  805  805  805  805  805  805  871  939  939  939 1006 1006 1006 1006 1006  939  939  939  873  805  805  805  805  805  805  805  805  805  808  808  808  941  942  942  162  484  485  485  682  683  683  683  683  683  683  683  683  683  683  683  683  683  683  683  683  683  683  683  683 
 805  805  805  805  807  805  805  805  805  805  805  805  805  805  805  805  871  939  939  939  940  805  805  805  805  805 1005 1006  939  939  873  805  805   10  805  805  805  805  805  808  808  808  941  942  942  162  484  485  615  281  683  683  683  683  683  683  683  683  683  683  683  683  683  683  683  683  683  683  683  683 
 805  805  805  805  805  805  805  805  805  805  805  805  805  805  805  805  938  939  939 1007  805  805  805  805  805  805  805  805 1005  939  939  940  805  805  805  805  805  805  805  808  808  874  942  942  162  162  484  485  749  284  683  683  683  683  683  683  683  683  683  683  683  683  683  683  683  683  683  683  683  683 
 805  805  805  805  805  804  806  806  804  805  805  805  805  805  805  805  938  939 1007  805  805  805  805  805  805  805  274  805  805 1005 1006  939  873  805  805  805  805  805  805  808  808  941  942  942  162  162  551  686  485  682  683  683  683  683  683  683  683  683  683  683  683  683  683  683  683  683  683  683  683  683 
 805  805  805  805  805  805  805  805  805  805  805  805  805  805  805  871  939 1007  805  805  805  805  609  611  805  805  805  805  805  805  805 1005 1006  872  873  805  805  805  805  805  808 1008  942  942  942  162  162  484  485  749  284  683  683  683  683  683  683  683  683  683  683  683  683  683  683  683  683  683  683  683 
 805  805  805  805  805  805  805  805  805  805  805  805  805  805  871  939  940  805  805  805  805  609  677  677  610  610  611  805  805  805  805  805  805 1005  939  873  805  805  805  805  808  808  941  942  942  162  162  484  485  485  682  683  683  683  683  683  683  683  683  683  683  683  683  683  683  683  683  683  683  683 
 805  805  805  805  805  805  805  805  805  805  805  805  805  805  938  939  940  805  805  805  805  743  677  677  677  805  678  805  807  805  805  805  805  805 1005 1007  805  805  805  808  808  808  941  942  942  162  162  162  551  485  749  284  683  683  683  683  683  683  683  683  683  683  683  683  683  683  683  683  683  683 
 805  805  805  677  805  805  805  805  805  805  805  805  805  805  938  939  940  805  805  805  805  805  743  677  677  677  677  611  805  805  805  805  805  805  805  805  805  805  805  808  808  874  942  942  942  162  162  162  417  485  485  682  683  683  683  683  683  683  683  683  683  683  683  683  683  683  683  683  683  683 
 805  805  805  805  805  805  805  805  805  805  805  805  805  805  938  939  940  805  805  805  805  805  805  743  677  677  677  678  805  805  805  805  805  805  805  871  873  805  805  808  808  941  942  942  162  162  162  162  484  485  485  682  683  683  683  683  683  683  683  683  683  683  683  683  683  683  683  683  683  683 
 805  805  805  805  805  805  805  871  871  872  873  805  871  872  939  939 1007  805  805  805  805  805  805  805  743  677  677  745  805  805  805  805  805  805  805 1005  939  873  805  808  808  941  942  942  162  162  162  162  484  485  615  281  683  683  683  683  683  683  683  683  683  683  683  683  683  683  683  683  683  683 
 805  805  805  805  805  805  805  938  939  939  939  872  939  939  939  940  805  805  805  805  805  805  805  805  805  743  745  805  805  805  805  805  805  805  805  805  938  940  805  805  807  941  942  942  162  162  162  162  484  485  682  683  683  683  683  683  683  683  683  683  683  683  683  683  683  683  683  683  683  683 
 805  274  805  805  805  805  871  939  939 1006 1006 1006 1006  939  939  940  805  805  805  805  805  804  806  806  804  805  805  805  805  805  805  805  805  805  807  805  938  940  805  805  808  941  942  942  162  162  162  162  484  485  682  683  683  683  683  683  683  683  683  683  683  683  683  683  683  683  683  683  683  683 
 805  805  805  805  805  871  939  939 1007  805  805  805  805  938  939  940  805  805  805  805  805  805  805  807  805  805  805  805  805  805  805  805  805  805  805  805 1005 1007  805  805  808  941  942  942  162  162  162  162  484  485  682  683  683  683  683  683  683  683  683  683  683  683  683  683  683  683  683  683  683  283 
 805  805  805  871  872  939  939 1007  805  805  805  805  805 1005  939  939  872  872  873  805  805  805  805  805  805  805  807  805  805  805  805  805  805  805  805  805  805  805  805  805  874  942  942  942  162  162  162  417  485  485  682  683  683  683  683  683  683  683  683  683  683  683  683  683  683  683  683  683  283  751 
 805  805  871  939  939  939 1007  805  805  805  807  805  805  805 1005  939  939  939  940  805  805  805  805  805  805  805  805  805  805  805  807  805  805  874  875  875  875  876  805  807  941  942  942  162  162  162  162  484  485  485  749  284  683  683  683  683  683  683  683  683  683  683  683  683  683  683  683  283  751  485 
 805  805 1005  939  939  940  805  805  805  805  805  805  805  805  805 1005 1006  939  940  805  805  807  805  805  805  874  875  876  805  805  808  805  874  942  942  942  942  942  876  805 1008 1009  942  942  162  162  162  484  485  485  485  682  683  683  683  683  683  683  683  683  683  683  683  683  283  750  750  751  553  551 
 805  805  805 1005  939  940  805  805  805  805  805  805  805  806  805  805  805  938  940  805  805  807   22   22  874  942  942  942  876  805  808  805  941  942  942  942  942  942  942  876  808  808  941  942  162  162  162  162  551  485  485  682  683  683  683  683  683  683  683  683  683  283  750  750  751  485  485  553  162  162 
 805  805  805  805 1005 1007  805  805  805  805  805  805  805  805  804  805  871 1006 1007  805  805  805   22   22  941  942  162  942  943  805  805  805  941  942  942  162  942  942  942  943  808  808  941  942  162  162  162  162  417  485  485  749  750  750  750  284  683  683  283  750  750  751  485  485  485  485  553  162  162  162 
 805  805  805  805  805  805  805  805  805  805  805  805  807  807  871  872  940  805  874  875  875  876  807   22  941  942  162  162  942  876  805  805  941  942  942  942  162  162  942  942  876  874  942  942  162  162  162  417  485  485  485  485  485  485  485  749  750  750  751  485  485  553  551  485  485  553  162  162  162  162 
 805  805  805  807  807  805  805  805  805  807  805  805  807  805  939  939  940  805  941  942  942  943  805  805  941  942  942  162  162  943   22  874  942  942  942  942   91   93  162  942  942  942  942  162  162  162  162  551  552  552  552  552  552  552  552  552  552  485  485  552  553  162  162  551  553  162  162  162  162  162 
 805  805  805  805  805  805  805  805  805  805  805  805  871  872  939  939 1007  874  942  805  805  943  805  874  942  942  942  942  942  942  875  942  942  942  942  942  158  160  162  942  942  942  162  162  162  162  162  162  162  162  162  162  162  162  162  162  162  551  553  162  162  162  162  162  162  162  162  162  162  162 
 805  805  805  805  805  805  805  805  805  805  807  807  938  939  939 1007  805  941  942  942  942  942  875  942  942  942  942  942  942  942  942  942  942  942  942  942  158  160  162  162  942  942  162  162  162  162  162  162  162  162  162  162  162  162  162  162  162  162  162  162  162  162  162  162  162  162  162  162  162  162 
 805  805  805  805  874  875  876  805  805  805  807  805 1005  939  940  805  874  942  942  942  942  942  942  942  942  942  942  942  942  942  942  942  942  942  942  942  225  227  162  162  942  162  162  162  162  162  162  162  162  162  162  162  162  162  162  162  162  162  162  162  162  162  162  162  162  162  162  162  162  162 
 805  807  805  808  941  942  942  876  805  805  805  805  805  938  940  874  942  942  942  942  942  942  942  942  942  942  942  942  942  942  942  942  942  942  942  942  942  942  162  162  162  162  162  162  162  162  162  162  162  162  162  162  162  162  162  162  162  162  162  162  162  162  162  162  162  162  162  162  162  162 
 805  805  805  874  942  942  942  942  875  875  875  875  876  938  939   91   92   93  942  942  942  942  942  942  942  162  942  942  942  942  942  942  942  942  942  942  942  942  942  162  162  162  162  162  162  162  162  162  162  162  162  162  162  162  162  162  162  162  162  162  162  162  162  162  162  162  162  162  162  162 
 805  805  874  942  942  162  942  942  942  942  942  942  162  162  162  225  226  226   92   93  942  942  942  942  942  162  162  942  942  942  942  942  942  942  942  942  942  942  942  162   91   93  162  162  162  162  162  162  162  162  162  162  162  162  162  162  162  162  162  162  162  162  414  415  416  162  162  162  162  162 
 805  805 1008  942  942  942  942  942  942  942  942  162  162  162  162  162  162  162  225  159   92   92   93  942  942  942  162  162  162  942  942  942  942  942  942  942  942  942  942  162  225  227  162  162  162  162  162  162  162  414  415  415  415  416  162  162  162  162  162  162  162  162  548  482  482  416  162  162  162  162 
 805  807  805 1008 1009 1009  942  942  942  942  162  162  414  415  415  416  162  162  162  225  226  226  227  942  942  942  942  162  162  942  942  942  942  942  942  942  942  942  942  942  162  162  162  162  162  162  162  162  162  548  482  482  482  550  162  162  162  162  162  162  162  162  162  548  482  483  162  162  162  162 
 805  807  805  805  805  805  941  942  942  162  162  162  481  482  482  482  415  415  415  416  162  162  162  942  942  942  942  942  942  942  942  942  942  942  942  942  942  942  942  942  942  162   91   92   93  162  162  162  162  162  481  482  483  162  162  162  162  162  162  162  162  162  162  162  481  482  416  162  162  162 
 805  805  805  805  805  874  942  942  162  162  162  414  482  482  482  482  482  482  482  483  162  162  162  942  942  942  942  942  942  942  942  942  942  942  942  942  942  942  942  942  942  942  225  159  159  162  162  162  162  162  548  549  550  162  162  162  162  162  162  162  162  162  162  162  548  482  483  162  162  162 
 805  807  805  874  875  942  942  942  162  162  162  481  482  482  482  482  482  482  482  482  416  162  162   91   93  942  942  942  942  942  942  942  942  942  942  942  942  942  942  942  942  942  162  158  159   93  162  162  162  162  162  162  162  162  162  162  162  162  162  162  162  162  162  162  162  548  550  162  162  162 
 807  805  805  941  942  942  942  162  162  162  414  482  482  482  482  482  482  482  482  482  482  416  162  158  160  160  942  942  942  942  942  942  942  942  942  942  942  942  942  942  942  942  162  225  159  160  162  162  162  162  162  162  162  162  162  162  162  162  162  162  162  162  162  162  162  162  162  162  162  162 
 805  805  874  942  942   91   93  162  162  414  482  482  482  482  482  482  482  482  482  482  482  483  162  158  160  227  942  942  942  942  942  942  942  942  942  942  942  942  942  942  942  942  162  162  225  159   93  162  162  162  162  162  162  162  162  162  162  162  162  162  162  162  162  162  162  162  162  162  162  162 
 805  874  942  942  942  158  160  162  414  482  482  482  482  482  482  482  482  482  482  482  482  483  162  225  159   93  942  942  942  942  942  942  942  942  942  942  942  942  942  942  942  942  942  162  162  225  159   93  162  162  162  162  162  162  162  162  162  162  162  162  162  162  162  162  162  162  162  162  162  162 
 874  942  942  942  805  158  160  162  481  482  482  482  482  482  482  482  482  482  482  482  482  483  162  162  158  160  942  942  942  942  942  942  942  942  942  942  942  942  942  942  942  942  942  942  162  162  225  160  162  162  162  162  162  162  162  162  162  162  162  162  162  162  162  162  162  162  162  162   91   92 
 942  942  942  942   91  159  160  162  481  482  482  482  482  482  482  482  482  482  482  482  482  483  162  162  225  227  942  942  942  942  942  942  942  942  942  942  942  942  942  942  942  942  942  162  162  162  162  158   93  162  162  162  162  162  162  162   91   92   93  162  162  162  162  162  162  162  162  162  158  159 
 942  942  942  942  225  226  227  162  481  482  482  482  482  482  482  482  482  482  482  482  482  483  162  162  162  162  942  942  942  942  942  942  942  162  942  942  942  942  942  942  942  942  942  942  162  162  162  225  159   93  162  162  162  162  162   91  159  159  227  162   91   92   92   92   93  162  162  162  158  159 
 942  942  942  942  162   91   93  162  548  482  482  482  482  482  482  482  482  482  482  482  482  483  162  162  162  162  942  942  942  942  942  942  162  162  162  942  942  942  942  942  942  942  942  942  942  162  162  162  225  159   93  162  162  162  162  158  159  227  162  162  225  226  226  159  159   92   92   92  159  159 
 942  942  942  942   91  159  160  162  162  481  482  482  482  482  482  482  482  482  482  482  482  482  416  162  162  162  942  942  942  942  942  942  805  162  162  162  942  942  942  942  942  942  942  942  942  942  162  162  162  225  226   92   93  162  162  225  227  162  162  162  162  162  162  225  226  226  226  226  159  159 
 942  942  942  942  225  226  227  162  162  548  549  549  482  482  482  482  482  482  482  482  482  482  483  162  162  162  159  942  942  942  942  942  942  162  162  162  942  942  942  942  942  942  942  942  942  162  162  162  162  162  162  225  159   93  162  162  162  414  416  162  162  162  162  162  162  162  162  162  225  226 
 942  942  942  942  162   91   92   92   93  162  162  162  548  549  549  549  549  482  482  482  482  482  482  416  162  162  162  160  942  942  942  942  942  162  162  162  942  942  942  942  942  942  162  162  162  162  162  162  162  162  162  162  158  159   93  162  162  548  482  415  416  162  162  162  162  162  162  162  162  162 
 942  942  942  942  805  225  226  159  159   93  162  162  162  162  162  162  162  548  482  482  549  549  549  550  162  162  162  162   92  942  942  942  942  162  162  162  942  942  942  942  942  162  162  162  162  162  162  162  162  162  162  162  158  159  227  162  162  162  481  482  550  162  162  162  162  162  162  162  162  162 
 942  942  942  942  942  805  805  225  226  226   93  162  162  162  162  162  162  162  548  550  162  162  162  162  162  162  162  162  162  162  942  162  162  162  162  162  162  162  942  942  942  162  162  162  162  162  162  162  162  162  162  162  158  160  162  162  162  162  481  483  162  162  162  162  162  162  162  162  162  162 
 942  942  942  942  942  942  942  942  942  805  162  942  942  942  942  942  162  162  162  162  162  162  162  162  162  162  162  162  162  162  162   91   92   93  162  162  162  162  162  942  942  162  162  162  162  162  162  162  162  162  162  162  158  160  162  162  162  162  548  550  162  162  162  162  162  162  162  162  162  162 
 942  942  942  942  942  942  942  942  942  942  942  942  942  942  942  942  942  942  942  162  162  162  162  162  162  162  162  162  162  162  162  225  226  226   92   93  162  162  162  162  162  162  162  162  162  162  162  162  162  162  162   91  159  160  162  162  162  162  162  162  162  162  162  162  162  162  162  162  162  162 
 942  942  942  942  942  942  942  942  942  942  942  942  942  942  942  942  942  942  942  942  942  942  162  162  162  162  162  162  162  162  162  162  162  162  226  226   92   93  162  162  162  162  162  162  162  162  162  162  162  162   91  159  226  227  162  162  162  162  162  162  162  162  162  162  162  162  162  162  162  162 
 942  942  942  942  162  942  942  942  942  942  942  942  942  942  942  942  942  942  942  942  942  942  942  162  162  162  162  162  162  162  162  162  162  162  414  416  225  159   92   93  162   91   92   92   92   92   92   93  162   91  159  160  162  162  162  162  162  162  162  162  162  162  162  162  162  414  416  162  414  416 
 942  942  942  942  942  942  942  942  942  942  942  942  942  942  942  942  942  942  942  942  942  942  942  942  942  162  162  162  162  162  162  162  414  415  482  483  162  225  226  226  162  158  159  159  159  159  159  159   92  159  226  227  162  162  162  162  162  162  162  162  162  162  162  162  162  548  482  415  482  482 
 942  942  942  942  942  942  942  942  942  942  942  942  942  942  942  942  942  942  942  942  942  942  942  942  942  942  162  162  162  162  162  162  481  482  482  483  162  162  162  162  162  225  226  226  226  226  226  226  226  227  162  162  162  162  162  162  162  162  162  162  162  162  162  162  162  162  548  482  482  482 