 677  677  677  677  677  677  677  745   -1   -1   -1   -1   -1   -1   -1   -1   -1   -1   -1   -1   -1   -1   -1   -1   -1  729   -1   -1   -1  676  677  677  677  677  678   -1   -1   -1   -1   -1   -1  369   -1   -1   -1   -1   94   -1   -1   -1   -1   -1   -1   -1   -1   -1   -1   -1   -1   -1   -1   -1   -1   -1   -1   -1   -1   -1   -1   -1 
 677  677  455  677  677  677  677  745   -1   -1  369   -1   -1  729   -1   -1   -1   -1   -1   -1   -1   -1  837   -1   -1   -1   -1   -1  688  743  677  677  677  455  678   -1   -1   -1  729   -1   -1   -1   -1   -1  539   94  162   -1   -1   -1   -1   -1   -1   -1   -1   -1   -1   -1   -1   -1   -1   -1   -1   -1   -1   -1   -1   -1   -1   -1 
 743  677  677  677  677  677  678   -1   -1   -1   -1  368   -1   -1   -1   -1   -1   -1   -1   -1   -1   -1   -1   -1   -1   -1   -1   -1   -1   -1  743  744  677  677  745   -1   -1   -1   -1   -1   -1   -1   -1   94   95  162  162   -1   -1   -1   -1   -1   -1   -1   -1   -1   -1   -1   -1   -1   -1   -1   -1   -1   -1   -1   -1   -1   -1   -1 
  -1  743  744  744  677  677  678  688   -1   -1   -1   -1   -1   -1   -1   -1   -1   -1   -1  839   -1   -1   -1   -1   -1   -1   -1  369   -1   -1   52   -1  743  745   -1   -1   -1   -1  569   -1   -1   -1   -1  228   -1   -1   -1   -1   -1   -1   -1   -1   -1   -1   -1   -1   -1   -1   -1   -1   -1   -1   -1   -1   -1   -1   -1   -1   -1   -1 
  -1   -1   -1   -1  743  677  678   -1   -1   -1   -1   -1   -1   -1   -1   -1   -1   -1   -1   -1   -1   -1   -1   -1   -1   -1   -1   -1   -1   -1   -1   -1   -1   -1   -1   -1   -1   -1   -1   -1   -1   -1   -1  839  161  162   -1   -1   -1   -1   -1   -1   -1   -1   -1   -1   -1   -1   -1   -1   -1   -1   -1   -1   -1   -1   -1   -1   -1   -1 
  -1   -1   -1   -1   -1  452  745   -1   -1   -1   -1  729   -1   -1   -1   -1   -1   -1   -1   -1   -1   -1   -1   -1   -1   -1   -1   -1   -1   -1  707  708   -1  539   -1   -1  368   -1   -1   -1   -1   -1   -1   -1  161  539   -1   -1   -1   -1   -1   -1   -1   -1   -1   -1   -1   -1   -1   -1   -1   -1   -1   -1   -1   -1   -1   -1   -1   -1 
  -1  729   -1   -1   -1   -1   -1   -1   -1   -1   -1   -1   -1   -1   -1   -1   -1   -1   -1   -1   -1   -1   -1  837   -1   -1   -1   -1   -1   -1   -1   -1   -1   -1   -1   -1   -1   -1   -1   -1   -1   -1   -1   -1  161  162   -1   -1   -1   -1   -1   -1   -1   -1   -1   -1   -1   -1   -1   -1   -1   -1   -1   -1   -1   -1   -1   -1   -1   -1 
  -1   -1   -1   -1   -1   -1  569   -1   -1  539   -1   -1   -1  688   -1   -1   -1   -1   -1   -1   -1   -1   -1   -1   -1   -1   -1   -1   -1   -1   -1   -1   -1   -1   -1   -1  729   -1   -1  688   -1   -1   -1   -1  161   -1   -1   -1   -1   -1   -1   -1   -1   -1   -1   -1   -1   -1   -1   -1   -1   -1   -1   -1   -1   -1   -1   -1   -1   -1 
  -1   -1   -1   -1   -1   -1   -1   -1   -1   -1   -1   -1   -1   -1   -1   -1   -1   -1   -1   -1   -1   -1   -1   -1   -1   -1   -1   -1   -1   -1   -1  839   -1   -1   -1   -1   -1   -1   -1   -1   -1   -1   -1   94  162   -1   -1   -1   -1   -1   -1   -1   -1   -1   -1   -1   -1   -1   -1   -1   -1   -1   -1   -1   -1   -1   -1   -1   -1   -1 
  -1   -1   -1   -1   -1   -1  707  708   -1   -1   -1   -1   -1   -1   -1   -1   -1   -1   -1   -1   -1   -1   -1   -1   -1   -1   -1   -1   -1   -1   -1   -1   -1   -1   -1   -1   -1   -1   -1  788  789  790  791  228   -1   -1   -1   -1   -1   -1   -1   -1   -1   -1   -1   -1   -1   -1   -1   -1   -1   -1   -1   -1   -1   -1   -1   -1   -1   -1 
  -1   -1  369   -1  368   -1   -1   -1   52   -1  369   -1   -1   -1   -1   -1   -1   -1   -1  729   -1   -1   -1   -1   -1   -1   -1   -1   -1   -1   -1   -1   -1   -1   -1   -1   -1   -1   -1   -1   -1   -1   -1   -1  161   -1   -1   -1   -1   -1   -1   -1   -1   -1   -1   -1   -1   -1   -1   -1   -1   -1   -1   -1   -1   -1   -1   -1   -1   -1 
  -1   -1   -1   -1   -1   -1   -1   -1   -1   -1   -1   -1   -1   -1   -1   -1   -1   -1   -1   -1   -1   -1   -1   -1   -1   -1   -1   -1   -1   -1   -1   -1   -1   -1   -1   -1   -1   -1  369   -1   -1   -1   -1   -1  161  454   -1   -1   -1   -1   -1   -1   -1   -1   -1   -1   -1   -1   -1   -1   -1   -1   -1   -1   -1   -1   -1   -1   -1   -1 
  -1   -1   -1  609  610  453   -1   -1   -1   -1   -1   -1   -1   -1   -1   -1   -1   -1   -1   -1   -1   -1   -1   -1   -1  452   -1   -1   -1   -1   -1   -1   -1   -1   -1   -1   -1   -1   -1   -1   -1   -1  539   -1  161   -1   -1   -1   -1   -1   -1   -1   -1   -1   -1   -1   -1   -1   -1   -1   -1   -1   -1   -1   -1   -1   -1   -1   -1   -1 
  -1   -1  609  455  677  678   -1   -1  729   -1   -1   -1   -1   -1   -1   -1  839   -1   -1   -1   -1   -1   -1   -1   -1   -1   -1   -1   -1   -1   -1  729   -1   -1   -1   -1   -1   -1   -1   -1   -1   -1   -1   -1  161   -1   -1   -1   -1   -1   -1   -1   -1   -1   -1   -1   -1   -1   -1   -1   -1   -1   -1   -1   -1   -1   -1   -1   -1   -1 
  -1   -1  743  677  677  745   -1   -1   -1   -1   -1   -1  688   -1  837   -1   -1   -1   -1   -1   -1   -1   -1   -1   -1   -1  455   -1   -1   -1   -1   -1   -1   -1   -1   -1   -1   -1   -1  368   -1   -1   -1   94  162   -1   -1   -1   -1   -1   -1   -1   -1   -1   -1   -1   -1   -1   -1   -1   -1   -1   -1   -1   -1   -1   -1   -1   -1   -1 
  -1   -1   -1  743  745   -1   -1   -1   -1   -1   -1   -1   -1   -1   -1   -1   -1   -1   -1   -1  729   -1   -1   -1   -1   -1   -1   -1   -1   -1   -1   -1   -1   -1   -1   -1   -1   -1   -1   -1   -1   -1   -1  161   -1   -1   -1   -1   -1   -1   -1   -1   -1   -1   -1   -1   -1   -1   -1   -1   -1   -1   -1   -1   -1   -1   -1   -1   -1   -1 
  -1   -1   -1   -1   -1   -1   -1   -1   -1   -1   -1   -1   -1   -1   -1   -1   -1   -1   -1   -1   -1   -1   -1   -1   -1   -1   -1   -1   -1  569   -1   -1   -1  688   -1   -1   -1  837   -1   -1  788  789  790  791   -1   -1   -1   -1   -1   -1   -1   -1   -1   -1   -1   -1   -1   -1   -1   -1   -1   -1   -1   -1   -1   -1   -1   -1   -1   -1 
  -1   -1   -1   -1   -1   -1   -1   -1   -1   -1   -1   -1   -1   -1   -1   -1   -1   -1  688   -1   -1   -1  707  708   -1   -1   -1   -1   -1   -1   -1   -1   -1   -1   -1   -1   -1   -1   -1   -1   -1  839   -1  161   -1  690  691  692   -1   -1   -1   -1   -1   -1   -1   -1   -1   -1   -1   -1   -1   -1   -1   -1   -1   -1   -1   -1   -1   -1 
  -1   -1   -1   -1   -1   -1   -1   -1   -1   -1   -1   -1   -1   -1   -1   -1   -1   -1   -1   -1   -1   52   -1   -1   -1  368   -1   -1   -1  729   -1   -1   -1   -1   -1   -1  839   -1   -1   -1   -1   -1   -1  161   -1   -1   -1   -1   -1   -1   -1   -1   -1   -1   -1   -1   -1   -1   -1   -1   -1   -1   -1   -1   -1   -1   -1   -1   -1   -1 
  -1   -1   -1   -1   -1   -1   -1   -1   -1   -1   -1   -1   -1   -1   -1   -1   -1   -1  837   -1   -1  369   -1   -1   -1   -1   -1   -1   -1   -1   -1   -1   -1   -1   -1   -1   -1   -1   52   -1   -1   -1   94  162   -1   -1   -1   -1   -1   -1   -1   -1   -1   -1   -1   -1   -1   -1   -1   -1   -1   -1   -1   -1   -1   -1   -1   -1   -1   -1 
  -1   -1   -1  839   -1   -1   -1  788  789  790  791   -1   -1   -1   -1   -1   -1   -1   -1   -1   -1   -1   -1   -1   -1   -1   -1   -1   -1   -1   -1   -1   -1   -1   -1   -1   -1   -1   -1   -1   -1   -1  228   -1   -1   -1   -1   -1   -1   -1   -1   -1   -1   -1   -1   -1   -1   -1   -1   -1   -1   -1   -1   -1   -1   -1   -1   -1   -1   -1 
  -1   -1   -1   -1   -1   -1   -1  688   -1   -1  729   -1   -1   -1   -1   -1   -1   -1   -1   -1   -1   -1   -1   -1   -1   -1   -1   -1   -1   -1   -1   -1  788  789  790  791  730   -1   -1   -1   -1   -1   -1  161   -1   -1   -1   -1   -1   -1   -1   -1   -1   -1   -1   -1   -1   -1   -1   -1   -1   -1   -1   -1   -1   -1   -1   -1   -1   -1 
  -1   52   -1   -1   -1   -1   -1   -1   -1   -1   -1   -1   -1  707  708   -1   -1   -1   -1   -1   -1   -1  729   -1   -1   94   95   96   -1   -1   -1   -1   -1   94   95   96   -1   -1   -1   -1   -1   -1   -1  161  539   -1   -1   -1   -1   -1   -1   -1   -1   -1   -1   -1   -1   -1   -1   -1   -1   -1   -1   -1   -1   -1   -1   -1   -1   -1 
  -1   -1   -1   -1  837   -1   -1  369   -1  436  437   -1   -1  509  510   -1   -1   -1   -1   -1   -1   -1   -1  539   -1  161   -1  163   -1   -1   -1   -1   -1  228  229   -1   95   96   -1   -1   -1   -1   -1  161   -1   -1   -1   -1   -1   -1   -1   -1   -1   -1   -1   -1   -1   -1   -1   -1   -1   -1   -1   -1   -1   -1   -1   -1   -1   -1 
  -1   -1   -1   -1   -1   -1   -1   -1   -1  503  504   -1   -1   -1   -1   -1   -1   -1   -1   -1   -1   -1   -1   -1   -1  228   -1  931   96   -1  688   -1   -1   -1   -1  161   -1   -1   96   -1   -1   -1   -1  161   -1   -1   -1   -1   -1   -1   -1   -1   -1   -1   -1   -1   -1   -1   -1   -1   -1   -1   -1   -1   -1   -1   -1   -1   -1   -1 
  -1  729   -1   -1   -1   -1   -1   -1   -1   -1   -1   -1   -1   -1   -1   -1  839   -1   -1   94   96   -1   52   -1  839   -1  228   -1   -1   96   -1   -1   -1   -1   -1  161   -1   -1   -1   96   -1   -1   94   -1   -1   -1   -1   -1   -1   -1   -1   -1   -1   -1   -1   -1   -1   -1   -1   -1   -1   -1   -1   -1   -1   -1   -1   -1   -1   -1 
  -1   -1   -1   -1   -1   -1   -1   -1   -1   -1   -1   -1   -1   -1   -1   -1   -1   -1   94  162  162   96   -1   -1   -1   -1   -1  228  229  230   -1   -1   -1   -1   -1  161   -1   -1  454  163   -1   94   -1   -1   -1   -1   -1   -1   -1   -1   -1   -1   -1   -1   -1   -1   -1   -1   -1   -1   -1   -1   -1   -1   -1   -1   -1   -1   -1   -1 
  -1   -1   -1   -1   -1  368   -1   -1  729   -1   -1   -1  837   -1   -1   -1   -1   -1  228  229  229  230   -1   -1   -1   -1   -1   -1   -1   -1   -1   -1  539   -1   -1  161   -1   -1   -1  163   -1  161   -1   -1   -1   -1   -1   -1   -1   -1   -1   -1   -1   -1   -1   -1   -1   -1   -1   -1   -1   -1   -1   -1   -1   -1   -1   -1   -1   -1 
  -1   -1  688   -1   -1   -1   -1   -1   -1   -1   -1   -1   -1   -1   -1   -1   -1   -1  839   -1   -1   -1  556  557  788  789  790  791  839   -1   -1   -1   -1   -1   -1  228   -1   -1   -1   -1   95   -1   -1   -1   -1  539   -1   -1   -1  368   -1   -1  539   -1   -1   -1   -1   -1   -1   -1   -1   -1   -1   -1   -1  539   -1   -1   -1   -1 
  -1   -1   -1   -1   -1   94   96   -1   -1   -1   -1   -1   -1   -1   -1   94   95   96   -1   -1   -1   -1  623  624   -1   -1  368   -1   -1   -1   -1   -1   -1  863   -1   -1  228  229   -1   -1   -1   -1   -1   -1   -1   -1   -1   -1   -1   -1   -1   -1   -1   -1   -1   -1   -1   -1  931   -1   -1   -1   -1   -1   -1   -1   -1   -1   -1   -1 
  -1   -1   -1   -1   -1  161  163  788  789  790  791   -1   94   95   95   -1   -1   -1   95   96   -1  539   -1   -1   94   95   96   -1   -1   -1   -1   -1   -1  930  788  789  790  791  161   -1   -1   -1   -1   -1   -1   -1   -1   -1   -1   -1   -1   -1   -1   -1   -1   -1   -1   -1   -1   -1   -1   -1   -1   -1   -1   -1   -1   -1   -1   -1 
  -1   -1   -1   94   95  931  230   99  556  557   -1   94   -1   -1   -1   -1   -1   -1   -1   -1   95   95   95   96  228   -1   -1   95   95   96   -1  760   -1   -1   -1   99   -1  839  161   -1   -1   -1   -1   -1   -1  760   -1   -1   -1   -1   -1   -1   -1   -1   -1   -1   -1   -1  760   -1   -1   -1   -1   -1   -1   -1  185   -1   -1   -1 
  -1   -1   -1  228  229  230   -1  760  623  624   94   -1   -1   -1   -1   -1   -1   -1   -1   -1   -1   -1   -1  163   -1  228   -1   -1   -1  163   -1   -1   -1   -1   -1   -1   -1   -1  228   -1   -1   -1   -1   -1   -1   -1   -1   -1   -1   -1   -1   -1   -1   -1   -1   -1   -1   -1   -1   -1   -1  556  557   -1   -1   -1  252   -1   -1   -1 
  -1   -1   -1   -1   -1   -1   -1   -1   -1   94   -1   -1   -1   -1   -1   -1   -1   -1   -1   -1   -1   -1  227  163   -1   -1  228   -1   -1  230   -1   -1   -1   -1  556  557   -1   -1   -1  161   -1   -1   -1   -1   -1   -1   -1   -1  185   -1   -1  541   -1   -1   -1   -1   -1   -1   -1   -1   -1  623  624   -1   -1   -1   -1   -1   -1   -1 
  -1   -1   -1   -1   -1   -1   -1   -1   94   -1   -1   -1   -1   -1   -1   -1   -1   -1   -1   -1   -1   -1   -1  163   -1   -1   -1  228  230   -1   -1   -1   -1   -1  623  624   -1   -1   -1  228  229   -1   -1   -1   -1   -1   -1   -1  252   -1   -1   -1   -1   -1   -1   -1   -1   -1   -1   -1   -1   -1   -1   -1   -1   -1   -1   -1   -1   -1 
  -1  788  789  790  791   -1  839   -1  161   -1   -1   -1   -1   -1   -1   -1   -1   -1   -1   -1  454   -1   -1  162   95   96  839   -1   -1   -1  788  789  790  791   -1   -1   -1   -1   -1   -1   -1  161   -1   -1   -1   -1   -1   -1   -1   -1   -1   -1   -1   -1   -1   -1   -1   -1   -1   -1   -1   -1   -1   -1   -1   -1   -1   -1   -1   -1 
  -1   -1   -1   -1   -1   -1   -1   94   -1  185   -1   -1   -1   -1   -1  540   -1   -1   -1   -1   -1   -1   -1   -1   -1  163   -1   -1  863   -1   -1   -1  368   -1   -1   -1   -1   -1   -1   -1   -1  228   -1   -1   -1   -1   -1   -1   -1   -1   -1   -1   -1   -1   -1   -1   -1  539   -1   -1   -1   -1   -1   -1   -1   -1   -1   -1   -1   -1 
  -1   -1   -1   -1   94   95   95   -1   -1  252   -1   -1   -1   -1   -1   -1   -1   -1   -1   -1   -1   -1   -1   -1   -1  162   96   -1  930   -1   -1   -1   -1   -1   -1   -1   -1  539   -1   -1   -1   -1  161   -1   -1   -1   -1   -1   -1   -1   -1   -1   -1   -1   -1   -1   -1   -1   -1   -1   -1   -1   -1   -1   -1   -1   -1   -1   -1   -1 
  -1   -1   -1  863  161   -1   -1   -1   -1   -1   -1   -1   -1   -1   -1   -1   -1   -1   -1   -1   -1   -1   -1   -1   -1  162  163   -1   -1   -1   -1   -1   -1   -1  839   -1   -1   -1   -1  839   -1   -1  161   -1   -1   -1   -1  690  691  692   -1   -1   -1   -1   -1   -1   -1   -1   -1   -1   -1   -1   -1   -1  368   -1   -1   -1   -1   -1 
  -1   -1   -1  930  161   -1   -1   -1   -1   -1   -1   -1   -1   -1   -1   -1   -1   -1   -1   -1   -1   -1   -1   -1   -1   -1  163   -1  556  557   -1  690  691  692   -1   -1   -1   -1   -1   -1   -1   -1  228   -1   -1   -1   -1   -1   -1   -1   -1  539   -1   -1  760   -1   -1   -1   -1   -1   -1   -1   -1   -1   -1   -1   -1   -1   -1   -1 
  -1   -1   -1   94  162   -1   -1   -1   -1   -1   -1   -1   -1   -1   -1   -1   -1   -1   -1   -1   -1   -1   -1   -1   -1   -1  163   -1  623  624   -1   -1   -1   -1  788  789  790  791  760   -1   -1   -1   -1  161   -1   -1   -1   -1   -1   -1   -1   -1   -1   -1   -1   -1   -1   -1   -1   -1   -1   -1   -1   -1   -1   -1   -1   -1   -1   -1 
  -1   -1   -1  161   -1   -1   -1   -1   -1   -1   -1   -1   -1   -1   -1   -1   -1   -1   -1   -1   -1   -1   -1   -1   -1   -1  163   -1   -1  368   -1   -1   -1   94   96   -1  839   -1   -1   -1   94   95   95   -1   -1   -1   -1   -1   -1   -1   -1   -1   -1   -1   -1   -1   -1   -1   -1   -1   -1   -1   -1   -1   -1   -1   -1   -1   -1   -1 
  -1  368   -1  161   -1   -1   -1   -1   -1   -1   -1   -1   -1  540   -1   -1   -1  540   -1   -1   -1   -1   -1   -1   -1   -1  163   -1   -1   -1   -1   -1   94   -1  163   -1   -1   -1   -1   -1  228  229  229  229   -1   -1   -1   -1   -1   -1   -1   -1   -1   -1   -1   -1   -1   -1   -1   -1   -1   -1   -1   -1   -1   -1   -1  454   -1   -1 
  -1   -1   -1  161   -1   -1   -1   -1   -1   -1   -1   -1   -1   -1   -1   -1   -1   -1   -1   -1   -1   -1   -1  556  557   -1  163   -1  839   -1   -1   94   -1   -1   -1   96   -1   -1  863   -1   -1   -1   -1   -1  228   -1   -1   -1   -1   -1   -1   -1   -1   -1   -1   -1   -1   -1   -1   -1   -1   -1   -1   -1   -1   -1   -1   -1   -1   -1 
 839   -1   -1  161   -1   -1   -1   -1   -1   -1   -1   -1   -1   -1   -1   -1   -1   -1   -1   -1   -1   -1   -1  623  624   -1  163   -1   -1   -1  539  228  162   -1   -1   -1   96   -1  930   -1   -1   -1  839   -1   -1  161   -1   -1   -1   -1   -1   -1   -1   -1   -1   -1   -1   -1   -1   -1   -1   -1   -1   -1   -1   -1   -1   -1   -1   -1 
  -1   -1   -1  161   -1   -1   -1   -1   -1   -1   -1   -1   -1   -1   -1   -1   -1   -1   -1   -1   -1   -1   -1   -1   -1   -1  162   96  788  789  790  791  161   -1   -1   -1  230   -1   -1   -1  539   -1   94   95   95   -1   -1   -1   -1   -1   -1   -1   -1   -1   -1   -1   -1   -1   -1   -1   -1   -1   -1   -1   -1   -1   -1   -1   -1   -1 
  -1   -1   -1  760   -1   -1   -1   -1   -1   -1   -1  454   -1   -1   -1   -1   -1   -1   -1   -1   -1   -1   -1   -1   -1   -1   -1  162   96   -1   -1   -1  161   -1   -1  163   -1   -1   -1   -1   -1   94   -1   -1   -1   -1   -1   -1   -1   -1   -1   -1   -1   -1   -1   -1   -1   -1   -1   -1   -1   -1   -1   -1   -1   -1   -1   -1   -1   -1 
  -1  863   -1  228  162   -1   -1   -1   -1   -1   -1   -1   -1   -1   -1   -1   -1   -1   -1   -1   -1   -1   -1   -1   -1   -1   -1   -1  162   96   -1   94  162   -1   -1   -1   95   95   96   -1   -1  161   -1   -1   -1   -1   -1   -1   -1   -1   -1   -1   -1   -1   -1   -1   -1   -1   -1   -1   -1   -1   -1   -1   -1  760   -1   -1   -1   -1 
  -1  930   -1   -1  228  229  162   -1   -1   -1   -1   -1  229   -1   -1   -1   -1   -1   -1   -1   -1   -1   -1   -1  368   -1   -1   -1   -1   -1   95  162   -1   -1   -1   -1   -1   -1  163   -1   -1  161   -1   -1   -1   -1   -1   -1  539   -1   -1   -1   -1   -1   -1   -1   -1   -1   -1   -1   -1   -1   -1   -1   -1   -1   -1   -1   -1   -1 
  -1  539   -1   -1   -1   -1  228  229  229  162   -1  163   -1  228  229  229   -1   -1   -1   -1   -1   -1   -1   -1   -1   -1   -1   -1  760   -1   -1   -1   -1   -1   -1   -1   -1   -1   -1   95   95   -1   -1  931   -1   -1   -1   -1   -1   -1   -1   -1   -1   -1   -1   -1   -1   -1   -1   -1  454   -1   -1  539   -1   -1   -1   -1   -1   -1 
  -1   -1   -1   -1   -1   -1   -1   -1   -1  228  229  230   -1   -1   -1   -1  228  229  229   -1   -1   -1   -1   -1   -1   -1   -1   -1   -1   -1   -1   -1   -1   -1   -1   -1   -1   -1   -1   -1   -1   -1   -1   -1   -1   -1  760   -1   -1   -1   -1   -1   -1   -1   -1   -1   -1   -1   -1   -1   -1   -1   -1   -1   -1   -1   -1   -1  556  557 
  -1   -1   -1   94   96   -1   -1   -1   -1  839   -1   -1   -1   -1   -1  760   -1   -1   -1  228  229  229   -1   -1   -1   -1   -1   -1   -1   -1   -1   -1   -1   -1   -1   -1   -1   -1   -1   -1   -1   -1   -1   -1   -1   -1   -1   -1   -1   -1   -1   -1   -1   -1   -1   -1   -1   -1   -1   -1   -1   -1   -1   -1   -1   -1   -1   -1  623  624 
  -1   -1   -1  228   -1   95   96   -1   -1   -1   -1  788  789  790  791   -1   -1   -1   -1   -1   -1   -1  228   -1   -1   -1   -1   -1   -1  690  691  692   -1   -1   -1   -1   -1   -1   -1   -1   -1   -1   -1   -1   -1   -1   -1   -1   -1   -1   -1   -1   -1   -1   -1   -1  368   -1   -1   -1   -1   -1   -1   -1   -1   -1   -1   -1   -1   -1 
  -1  839   -1   -1  228  229  230   -1   -1  368   -1   97  556  557  539   -1   -1   -1   -1  863   -1   -1   -1  228  229   -1   -1   -1   -1   -1   -1   -1   -1   -1   -1   -1   -1   -1   -1   -1   -1   -1   -1   -1   -1   -1   -1   -1   -1   -1   -1   -1   -1   -1   -1   -1   -1   -1   -1  690  691  692   -1   -1   -1   -1   -1   -1   -1   -1 
  -1   -1   -1   -1   -1   -1   -1   -1   -1   -1   -1   -1  623  624   -1  839   -1   -1   -1  930  788  789  790  791   97  161  454   -1   -1   -1   -1   -1   -1   -1   -1   -1   -1   -1   -1   -1   -1   -1   -1   -1   -1   -1   -1   -1   -1   -1   -1   -1   -1   -1   -1   -1   -1   -1   -1   -1   -1   -1   -1   -1   -1   -1   -1   -1   -1   -1 