  -1   -1   -1   -1   -1   -1   -1   -1   -1   -1   -1   -1   -1   -1   -1   -1   -1   -1   -1   -1 
  -1   -1   -1   -1   -1   -1  128   -1   -1   -1   -1   20   21   -1   -1   -1   -1   -1   -1  128 
 327  328  329   -1   -1   -1  158   -1   -1   -1   -1   50   51   -1   -1   -1   -1   -1   -1  158 
 357  358  359   -1   -1   -1  188   -1   -1   -1   -1   -1   -1   -1   -1   -1   -1   -1   -1  188 
  -1   -1   -1   -1   -1   -1   -1   -1   -1   -1   -1   -1   -1   -1   -1   -1   -1   -1   -1   -1 
  -1   -1   -1   -1   -1   -1   -1   -1   -1   -1   -1  237  114  239   -1   -1   -1   -1   -1   -1 
 327  328  329   -1   -1   -1  128   -1   -1   -1   -1   -1  238   -1   -1   -1   -1   -1   -1  128 
 357  358  359   -1   -1   -1  158   -1   -1   -1   -1   -1   -1   -1   -1   -1   22   23   24  158 
  -1   -1   -1   -1   -1   -1  188   -1   -1   -1   -1   -1   -1   -1   -1   -1   52   53   54  188 
  -1   -1   -1   -1   -1   -1   -1   -1   -1   -1   -1   -1   -1   -1   -1   -1   -1   -1   -1   -1 