 432  433  434  435  432  433  434  435  432  433  434  435  432  433  434  435  432  433  434  435  432  433  434  435  432  433  434  435  432  433  434  435  432  433  434  435  432  433  434  435  432  433  434  435  432  433  434  435  432  435 
 499  500  501  502  499  500  501  502  499  500  501  502  499  500  501  502  499  500  501  502  499  500  501  502  499  500  501  502  499  500  501  502  499  500  501  502  499  500  501  502  499  500  501  502  499  500  501  502  499  500 
 566  567  568  569  566  567  568  569  566  567  568  569  566  568  568  569  566  567  568  569  566  567  568  569  566  567  568  569  566  567  568  569  566  567  568  569  566  567  568  569  566  567  568  569  566  567  568  569  566  567 
 633  634  635  636  633  634  635  634  633  634  635  636  633  634  635  636  633  634  635  636  633  634  635  636  633  634  635  636  633  634  635  636  633  634  635  636  633  634  635  636  633  634  635  636  633  634  635  636  633  634 
 808  808  808  808  808  874  875  875  875  875  875  876  808  808  808  808  808  808  808  874  875  875  875  875  875  875  876  808  808  808  808  808  808  808  808  808  808  808  808  808  808  808  808  808  808  808  808  808  808  808 
 808  808  808  808  808 1008 1009  545  942  545 1009 1010  808  808  808  808  808  808  874  942  942  942  942  942  942  942  943  808  808  808  808  808  808  808  808  808  341  342  342  342  343  808  808  808  808  808  808  808  808  808 
 808  808  808  808  808  808  808 1008 1009 1010  808  808    6  808  808  808  808  808  941  942  942  942  942  942  942  942 1010  808  808  808  808  808  808  808  808  808  408  409  409  409  410  808  808  808  808  808  808  808  808  808 
 808  808  808  808  808  808  808  609  610  610  610  610  611  808  808  808  808  808 1008 1009 1009 1009  942  942  942 1010  808  808  808  808  808  808  808  808  808  808  475  476  476  476  477  808  808  808  808  808  808  808  808  808 
 808  808  808  808  808  808  609  677  677  677  677  677  678  808  808    6  808  808  808  808  808  808 1008 1009 1010  808  808  808  808  808  808  808    6  808  808  808  808  808  808  808  808  808  808  808  808  808  808  808  808  808 
 808  808  808  808  808  609  677  677  677  677  677  677  745  808  808  808  808  808  808  808  808  808  808  808  808  808  808  808  808  808  808  808  808  808  808  808    6  808  808  808  808  808  808  808  808  808  808  808  808  808 
 808  808  808  808  808  676  677  677  677  677  677  745  808  808  808  808  808  808  808  808  808  808  808  808  808  808  808  808  808  808  808  808  808  808  808  808  808  808  808  808  808  808  808  808  808  808  808  808  808  808 
 808  808  808  808  808  743  744  744  744  744  745  808  808  808  808  808  808  808  808  808  808  808  808  808  808  808  808  808  808  808  808  808  808  808  808  808  808  808  808  808  808  808  808  808  808  808  808  808  808  808 
 872  872  872  872  872  872  872  872  872  872  872  872  872  872  872  872  872  872  872  872  872  872  872  872  872  872  872  872  872  872  872  872  872  872  872  872  872  872  872  872  872  872  872  872  872  872  872  872  872  872 
 939  939  939  939  939  939  939  939  939  939  939  939  939  939  939  939  939  939  939  939  939  939  939  939  939  939  939  939  939  939  939  939  939  939  939  939  939  939  939  939  939  939  939  939  939  939  939  939  939  939 
1006 1006 1006 1006 1006 1006 1006 1006 1006 1006 1006 1006 1006 1006 1006 1006 1006 1006 1006 1006 1006 1006 1006 1006  939  939  939 1006 1006 1006 1006 1006 1006 1006 1006 1006 1006 1006 1006 1006 1006 1006 1006 1006 1006 1006 1006 1006 1006 1006 
 808  808  808  808  808  808  808  808  808  808  808  808  808  808   73   74   75  808  808  808  808  808  808  808  938  939  940  808  808  808  808  808  808  808  808  808  808  808  808  808  808  808  808  808  808  808  808  808  609  610 
 808  808  808  808  808  808  808  808  808  808  808  808  808   73  141  141  141   74   75    6  808  808  808  808  938  939  940  808  808  808  808  808  808  808  808  808  808  808  808   73   74   75  808  808  808  808  808  609  677  677 
 808  808  808  808  808  808  808  808  808  808  808  808   73  141  141  141  141  141  142  808  808  808  808  808  938  939  940  808    6  808  808  808  808  808  808  808  808  808    7   73  141  141   74   75  808  808  609  677  677  677 
 808  808  808  808  808  808  808  808  808    6  808  808  207  141  141  141  141  141  142  808  808  808  808  808  938  939  940  808  808  808  808  808  808  609  610  611  808  808  808  140  141  141  141  142  808  808  744  677  677  677 
 808  808  808  808  808  808  808  808  808  808  808  808  207  207  208  208  208  208  208  808  808  808  808  808  938  939  940  808  808  808  808  808    6  676  677  677  611  808  808  140  141  141  141  209  808  808  808  744  744  744 
 808  808  808  808  808  808  808  808  808  808  808  609  611  808  808  808  808  808  808  808  808  808  808  808  938  939  940  808  808  808  808  808  808  743  677  677  677  611  808  207  141  141  142  808  808  808  808  808  808  808 
 808  808  808  808  808  808  808  808  808  808  609  677  677  611  808  341  342  342  342  342  343  808  808  808  938  939  940  808  808  808  808  808  808  808  743  677  677  678  808  808  207  208  209  808  808  808  808  808  609  610 
 808  808  808  808  808  808  808  808  808  609  677  677  677  745  808  408  409  409  409  409  410  808  808  808  938  939  940  808  808  808  808  808  808  808  808  743  744  745  808  808  808  808  808  808  808  808  808  609  677  677 
 808  808  808  808  808  808  808  808  808  676  677  677  745    6  808  408  409  409  409  409  410  808    6  808  938  939  940  808  808  808  808  808  808  808  808  808  808  808  808  808  808  808  808  808  808  808  808  609  677  677 
 808  808  808  808  808  808  808  808  808  743  744  745  808  808  808  408  409  409  409  409  410  808  808  808  938  939  940  808  808  808  808  808  808  808  341  342  343  808  808  808  808  808  808  808  808  808  808  676  677  677 
 808  808  808  808  808  808  808  808  808  808  808  808  808  808  808  475  476  476  476  476  477  808  808  808  938  939  940  808  808  808  808  808  808  808  408  409  410  808  808  808  808  808  808  808  808  808  609  677  677  677 
 808  808  808  808  808  808  808  808  808  808  808  808  808  808  808  808    6  808  808  808    6  808  808  808  938  939  940  808  808  808  808  808  808  808  475  476  477  808  808  808  808  808  808  808  808  808  676  677  677  677 
 808  808  808  808  808  808  808  808  808  808  808  808  609  610  611  808  808  808  808  808  808  808  808  808  938  939  940  808  808  808  808  808  808  808  808  808  808  808  808  808  808  808  808  808  808  609  677  677  677  677 
 808  808  808  808  808  808  808  808  808  808  808  609  677  677  677  610  611  808  808  808  808  808  808  808  938  939  940  808  808  808  808  808  808    8  808  808  808  808  808  808  808  808  808  808  609  677  677  677  677  677 
 808  808  808  808  808  808  808  808  808  808  609  677  677  677  677  677  677  610  611  808  808  808  808  808 1005 1006 1007  808  808  808  808  808  808  808  808  808  808  808  808  808  808  808  808  609  677  677  677  677  677  677 