  -1   -1   -1   -1   -1   -1   -1   -1   -1   -1   -1   -1   -1   -1   -1   -1   -1   -1   -1   -1 
  -1   -1   -1  175  176   -1   -1   -1   -1   -1   -1   20   21   -1   -1   -1   -1   -1   -1   -1 
  -1   -1   -1   -1   29   -1   -1   -1   -1   -1   -1   50   51   -1   -1   -1   -1   -1   -1   -1 
  -1   -1   -1   -1   -1   -1   -1   -1   -1   -1   -1   80   81   -1  265   -1   -1   -1   -1   -1 
  -1   -1   -1   -1   -1   -1  218   -1   -1   -1   -1   -1   -1   -1   -1   -1   -1   -1   -1  218 
  -1   -1   -1   -1  299   -1   -1   -1   -1   -1   -1   -1   -1   -1   -1   -1   -1   -1   -1   -1 
  -1   -1   -1   -1   -1   -1   -1   -1   -1   -1   -1  297  144  269   -1   -1   -1   -1   -1   -1 
  -1   -1   -1   -1   -1   -1   -1   -1   -1   -1   -1   -1   -1   -1   -1   -1   -1   -1   -1   -1 
  -1   -1   -1   -1   -1   -1   -1   -1   -1   -1   -1   -1   -1   -1   -1   -1   -1   -1   -1   -1 
  -1   -1   -1   -1   -1   -1  218   -1  414   -1   -1   -1   -1   -1   -1   -1   82   83   84  218 