 808  808  808  808  808  808  808  808  546  546  341  342  343  808  808  808  808  808  808  808  808  808  808  938  940  808  808  808  808  808  808  808  808  808  808  808  808  808  808  808  808  808  808  808  808  808  808  808  808  808 
 808  808  808  808  808  808  808  808  808  808  408  409  410  808  808  808  808  808  808  808  808  808  808 1005  939  872  873  808  808  808  808  808  808  808  808  808  808  808  808  808  808  808  808  808  808  808  808  808  808  808 
 808  808  808  808  808  808    6  808  808  341  409  409  409  342  343  808  808  808  808    6  808  808  808  805 1005 1006  939  873  808  808  808  808  808  808  808  808  808  808  808  808  808  338  339  340  808  808  808  808  808  808 
 808  808  808  808  808  808  808  808  808  408  409  409  409  409  410  808  808  808  808  808  808  808  808  546  808  808  938  940  808  808  808  808  808  808  808  808   73   74   75  808  808  405  406  407  808  808  808  808  808  808 
 808  808  808  808  808  808  808  808  808  475  476  476  476  476  477  808  808  807  808  808  808  808  804  804  808  808  938  940  808  808  808  808  808  808  808  808  140  141  142  808  808  472  473  474  808  808  808  808  808  808 
 808  808  808  808  808  808  808  808  808  808  808  808  808  808  808  808  808  277  808  808  808  808  808  546  808  807  938  940  808  808  808  808  808  808  808  808  207  208  209  808  804  808  808  808  808  808  808  808  808  808 
 808    6  808  808  808    6  808  808  808  808  808  808  808  808  808  808  808  808  808  808  808  808  808  871  872  872  939 1007  808  808  808  808  808  808  808  808  808  808  808  808  808  804  808  808  808  808  808  808  808  808 
 808  808  808  808  808  808  808  808  808  808  808  808  808  808  808  808  808  808  808  808  808  808  871  939 1006 1006 1007  808  808  808  808  808  808  808  808  808  808  808  808  808  808  808  808  808  808  808  808  808  808  808 
 808  808  808  808  808  546  808  808  808  808  808  808  546  808  808  808  808  808  808  808  808  871  939 1007  804  808  808  808  808  808  808  808  808  808  808  808  808  871  872  872  872  872  872  872  873  808  808  808  808  808 
 808  808  808  808  808  808  808  808  808  808  808  808  808  808  808  808  808  808  808  808  871  939 1007  805  804  808  808  808  808  808  808  808  808  808  808  808  808  938  939  939  939  939  939  939  940  808  808  808  808  808 
 808   73   74   75  877  878  879  808  808  808  808  808  808  808  808  808  808  808  808  807 1005  940  807  805  805  804  808  808  808  808  808  808  808  808  808  808  808  938  939  939  939  939  939  939  940  808  808  808  808  808 
 808  140  141  142  944  945  946  808  808  808  808  808  808  808  808   83  808  808  808  808  808 1005  872  873  805  808  808  808  808  808  808  808  808  808  808  808  808  938  939  939  939  939  939  939  940  808  808  808  808  808 
 808  207  208  209 1011 1012 1013  808  808  808  808  808  808  553  806  808  808  808  808  808  808  808 1005  939  873  804    6  808  808  808  808  808  808  808  808  808  808  938  939  939  939  939  939  939  940  808  808  808  808  808 
 808  808  808  808  808  808  808  808   83  808  808  808  809  808  808  808  808  808  808  609  611  808  808  938  940  808  808  808  808  808  808  808  550   80   80  808  808  938  939  939  939  939  939  939  940  808  808  808  808  808 
 808  808  808  808  808  808  808  808  808  808  808  808  808  808  804  808  808  808  808  676  745  808  808 1005  940  804  546  808  808  808  808  808  817  147  147  808  808 1005 1006  939  939  939 1006 1006 1007  808  808  808  808  808 
 808  808  808  808  871  872  872  873  808  804  807  808  808  808  808  808  808  609  544  745  808  808  808  804 1005  873  804  808  808  807  808  807  807  808  808  808  808  808  808  938  939  940  808  808  808  808  808  808  808  808 
 808  808  808  808  938  272  273  940  808  871  872  873  808  808  808  808  808  676  808  808  808  807  807  808  804  938  873  808  808  808  871  872  873  808    6  808  808  808  804  938  939  940  808  808  808  808  808  808  808  808 
 808  808  808  808  938  271  272  940  808 1005  939  940  808  808  808    6  808  676  808  808  808  808  807  808  808  938  940  808  808  808 1005  939  939  873  808  808  808  804  808  938  939  940  808  808  808  808  808  808  808  808 
 808  808  808  808 1005 1006 1006 1007  808  805  938  940  808  808  804  808  808  743  745  808  808  808  874  876  807  938  940  808    6  808  808  938  939  940  808  542  808  609  808 1005 1006 1007  808  808  808  808  808  808  808  808 
 808  808  808  808  808  808  808  808  808  871  939  939  872  940  808  808  808  808  874  875  875  875  942  943  808  938  940  808  808  542  808  938  939  940  808  808  546  676  808  808  808  808  808  808  808  808  808  808  808  808 
 808  808  808    6  808  804  808  805  808 1005 1006  939  939  939  872  873  805  805  941  942  942  942  942  942  943  938  940  808  808  808  871  939  939 1007  808  804  808  676  808  808  808  808  808  808  808  808  808  808  808  808 
 808  808  808  808  808  808  808  808  808  808  808 1005 1006  939  939  939  873  805 1008 1009 1009 1009 1009 1009 1010  938  940  807  808  871  939  939 1007  804  808  808  808  676  808  808  808  808  808  808  808  808  808  808  808  808 
 808  808  808  808  808  808  808  808  808  808  808  808  805 1005 1006  939  939  873  808  807  808  871  873  808  808  938  940  808  808  938  939  940  808  808  808  542  542  808  808  808  808  808  808  808  808  808  808  808  808  808 
 808  808  808  808  808  808  808  808  808  808  808  808  808  808  808 1005  939  939  872  872  872  939 1006  872  872  939  939  872  872  939  939  940  808  808  542  542  808  808  808  550  550  808  550   80  808  808  808  808  808  808 
 808  808  808  808  808  808  808  808  808  808  808  808  808    6  808  805 1005 1006  939  939  939 1007  807 1005 1006 1006 1006 1006 1006 1006  939  940  544  544  678  808  808  808  808  817  817  808  817  817  808  808  808  808  808  808 
 808    7    7    7    7  808 1006  808  808  808  808  808  808  808  808  807  808  805  938  939 1007  808  804  807  807  808  808  808  808  807 1005  939  873  808  808  809  808  808  808  808  807  807  807  808    6  808  808  808  808  808 
 808  808  808  808  808  808  808  808  808  808  808  808  808  808  808  808  805  871  939 1007  808  807  808  808  808  808  808  808  811  807  808 1005  939  872  872  872  872  872  872  872  873  804  807  804  871  873  804  807  804  808 
 808  808  808  808  808  550   83  808  808  808  808  808  808  808  808  808  805  938  940  808  808  808  808  808  808  808  808  808  808  808  808  808 1005 1006 1006 1006 1006 1006 1006 1006  939  872  872  872  939  939  872  806  872  872 
 808  808  808  808  808  817  817  808  808  808  808  808  808  808  808  809  871  939  940  808    6  808  808  808  808  808  808  808  808  808  808  808  808  808  808  547  808  808  808  808 1005 1006 1006 1006 1006 1006 1007  804 1005 1006 
 808  808  808  808  809  808  808  808  808  808  808  808  808  809  807  871  939  939  940  808  808  808  808  808  808   83   83  808  542  808  808  808  808  808  808  808  808  808  808  808  808  808  808  808  808  808  807  808  808  808 
 808  808  808  808  809  808  808  546  808  808  546  808  871  872  872  939  939  939  939  872  872  872  873  808  808  808  808  808  808  808  808  808  808  542  808  542  808  808  808  808  808  808    6  808  808  808  808  808  808  808 
 808  808  871  872  873  808  808  546  808  546  808  808  938  939 1006 1006 1006 1006 1006 1006 1006  939  940  804  808  808  808  808  808  808  542  808  808  808  808  808  808  808  808  808  808  808  808  808  808  808  808  808  808  808 
 808  808 1005 1006  939  872  872  872  872  872  872  872  939  940  807  808  807  808  807  805  808 1005 1006  872  873  808  808  808  808  808  808  808  808  542  542  808  808  808  808  808  808  808  808  808  808  808  808  808  808  808 
 808  808  809  808 1005 1006  939  939 1006 1006 1006 1006 1006 1007  808  808  808  808  808  808  808  808  808 1005  939  872  873  808  808  542  808  808  542  542  542  542  808  808  808  808  808  808    8  808  808  808  808  808  808  808 
 808  808  808  808  809  809  938  940  808  808  808  808  808  808  808  808  808  808  808  808  808  808  808  808 1005  939  940  808  808  808  808  808  545  808  808  808  808  808  808  808  808  808  808  808  808  808  808  808  808  808 
  78  808  808  808  808  808  938  940  808  808    8  808  546  808  808  808  808  808  808  808  808  546  808  808  808 1005  939  873  808  808  808  808  808  808  808  808  808  808  808  808  808  808  808  808  808  808  808  808  808  808 
 145    8  808  808  808  808  938  940  546  546  808  808  546  808  808  808  808  808  808  808  546  808    6  808  808  808 1005  939  873  808  808  808  808  808  808  546  808  808  808  808  808  808  808  808  808  808  808  808  808  808 
 212  808  808  808  808  808 1005  939  873  546  808  808  808  808  808  808  808   80   80  808  808  808  808  808  808  808  808  938  939  873  808  808  808  808  808  808  808  808  808  808  808  808  808  808  808  808  808  808  808  808 
 808  808  808  808  808  808  808 1005  939  873  546  808  808  808  808  808  808  147  147  808  808  808  808  808  808  808  808 1005  939  940  808  808  808  808    8  808  808  808  808  808  808  808  808  808  808  808  808  808  808  808 
 808  808  808  808  808  808  808  808 1005  939  872  873  808  808  808  546  546  808  808  808  808  808  808  808    8  808  808  808  938  940  808  808  808    6  808  808  808  808  808   83  550  808  808  550   83  751  808  808  808  808 
 808  808    6    6  808  808  808  808  546 1005  939  939  873  808  808  808  546  808  808  808  808  808  808  808  808  808  808  808 1005  939  873  808  808  808  808  808  808  808  808  817  817  808  808  817  817  818  808  808  808  808 
 808  808  808  808  808  808  808  808  808  546  938  939  940  808  546  871  872  940  808  808  808  808  808  808  808  808  808  808  808  938  939  873  808  808  808  808  808  808  808  808  808  807  809  808  808  808  808  808  808  808 
 808  808  808  808  808  808  808  808  808  808  938  939  939  872  872 1006 1006 1007  808  808  808  808  808  808  808  808  808  808  808 1005 1006  939  873  808  807  807  808  808  808  808  808  807  871  873  808  808  808  808  808  808 
 808  808  808  808  808  808  808  808  808  808 1005 1006 1006 1006 1007  804  808  808  808  808  808  808  808  808  808  808  808  808  808  808  808  938  939  872  872  872  873  808  808  808  808  871  939 1007  808  808  808  808  808  808 
 808  808  808  808    6  808  808  808  808  808  808  808  808  808  808  808  808  808  808  808  808  808  808  808  808  808  808  808  808  871  872  939 1006 1006 1006 1006  939  872  872  872  872  939 1007  808  808  808    6  808  808  808 
 808  808  808  808  808  808  808  808  808  808  808  808  808  808  808  808  808  808  808  808  808  808    6  808  808  807  808  808  871  939 1006 1006  808  808  808  808 1005  939  939  939  939  940  808  808  808  808  808  808  808  807 
 808   73   74   75  808  808  808  808  808  808  808  808  808    6  808  808  808  808  344  346  808  808  808  808  808  808  808  808  938  940  808  808  808  808  808  808  808 1005  939  939  939  939  872  872  872  872  872  872  873  807 
 808  140  141  142  808  808  808  808  808  808  808  808  808  808  808  808  808  804  478  480  804  808  808  808  808  807  807  807  938  940  808  808  808  808   73   74   75  808 1005 1006 1006 1006 1006 1006 1006 1006 1006 1006 1007  807 
 808  207  208  209  808  808  808  808    6  808  808  808  808  808  808  808  808  808  808  546  804  804  808  808  807  871  872  872  939  940  804  808  808  808  140  141  142  808  808  808  808  808  808  808  808  808  808  808  808  808 
 808  808  808  808  808  808  808  808  808  808  808  808  808  808  808  808  808  808  808  808  808  808  808  807  871  939  939  939  939  940  807  808  808  808  207  208  209  808  808  808  808  808  808  808  808  808  808  808  808  808 