{
  "largeur": 50,
  "hauteur": 30,
  "chipset": "VillageTangaFinal.png",
  "musique": "bahamut_lagoon.mp3",
  "couche0": [
    [ 432,  433,  434,  435,  432,  433,  434,  435,  432,  433,  434,  435,  432,  433,  434,  435,  432,  433,  434,  435,  432,  433,  434,  435,  432,  433,  434,  435,  432,  433,  434,  435,  432,  433,  434,  435,  432,  433,  434,  435,  432,  433,  434,  435,  432,  433,  434,  435,  432,  435],
    [ 499,  500,  501,  502,  499,  500,  501,  502,  499,  500,  501,  502,  499,  500,  501,  502,  499,  500,  501,  502,  499,  500,  501,  502,  499,  500,  501,  502,  499,  500,  501,  502,  499,  500,  501,  502,  499,  500,  501,  502,  499,  500,  501,  502,  499,  500,  501,  502,  499,  500],
    [ 566,  567,  568,  569,  566,  567,  568,  569,  566,  567,  568,  569,  566,  568,  568,  569,  566,  567,  568,  569,  566,  567,  568,  569,  566,  567,  568,  569,  566,  567,  568,  569,  566,  567,  568,  569,  566,  567,  568,  569,  566,  567,  568,  569,  566,  567,  568,  569,  566,  567],
    [ 633,  634,  635,  636,  633,  634,  635,  634,  633,  634,  635,  636,  633,  634,  635,  636,  633,  634,  635,  636,  633,  634,  635,  636,  633,  634,  635,  636,  633,  634,  635,  636,  633,  634,  635,  636,  633,  634,  635,  636,  633,  634,  635,  636,  633,  634,  635,  636,  633,  634],
    [ 808,  808,  808,  808,  808,  874,  875,  875,  875,  875,  875,  876,  808,  808,  808,  808,  808,  808,  808,  874,  875,  875,  875,  875,  875,  875,  876,  808,  808,  808,  808,  808,  808,  808,  808,  808,  808,  808,  808,  808,  808,  808,  808,  808,  808,  808,  808,  808,  808,  808],
    [ 808,  808,  808,  808,  808, 1008, 1009,  545,  942,  545, 1009, 1010,  808,  808,  808,  808,  808,  808,  874,  942,  942,  942,  942,  942,  942,  942,  943,  808,  808,  808,  808,  808,  808,  808,  808,  808,  341,  342,  342,  342,  343,  808,  808,  808,  808,  808,  808,  808,  808,  808],
    [ 808,  808,  808,  808,  808,  808,  808, 1008, 1009, 1010,  808,  808,    6,  808,  808,  808,  808,  808,  941,  942,  942,  942,  942,  942,  942,  942, 1010,  808,  808,  808,  808,  808,  808,  808,  808,  808,  408,  409,  409,  409,  410,  808,  808,  808,  808,  808,  808,  808,  808,  808],
    [ 808,  808,  808,  808,  808,  808,  808,  609,  610,  610,  610,  610,  611,  808,  808,  808,  808,  808, 1008, 1009, 1009, 1009,  942,  942,  942, 1010,  808,  808,  808,  808,  808,  808,  808,  808,  808,  808,  475,  476,  476,  476,  477,  808,  808,  808,  808,  808,  808,  808,  808,  808],
    [ 808,  808,  808,  808,  808,  808,  609,  677,  677,  677,  677,  677,  678,  808,  808,    6,  808,  808,  808,  808,  808,  808, 1008, 1009, 1010,  808,  808,  808,  808,  808,  808,  808,    6,  808,  808,  808,  808,  808,  808,  808,  808,  808,  808,  808,  808,  808,  808,  808,  808,  808],
    [ 808,  808,  808,  808,  808,  609,  677,  677,  677,  677,  677,  677,  745,  808,  808,  808,  808,  808,  808,  808,  808,  808,  808,  808,  808,  808,  808,  808,  808,  808,  808,  808,  808,  808,  808,  808,    6,  808,  808,  808,  808,  808,  808,  808,  808,  808,  808,  808,  808,  808],
    [ 808,  808,  808,  808,  808,  676,  677,  677,  677,  677,  677,  745,  808,  808,  808,  808,  808,  808,  808,  808,  808,  808,  808,  808,  808,  808,  808,  808,  808,  808,  808,  808,  808,  808,  808,  808,  808,  808,  808,  808,  808,  808,  808,  808,  808,  808,  808,  808,  808,  808],
    [ 808,  808,  808,  808,  808,  743,  744,  744,  744,  744,  745,  808,  808,  808,  808,  808,  808,  808,  808,  808,  808,  808,  808,  808,  808,  808,  808,  808,  808,  808,  808,  808,  808,  808,  808,  808,  808,  808,  808,  808,  808,  808,  808,  808,  808,  808,  808,  808,  808,  808],
    [ 872,  872,  872,  872,  872,  872,  872,  872,  872,  872,  872,  872,  872,  872,  872,  872,  872,  872,  872,  872,  872,  872,  872,  872,  872,  872,  872,  872,  872,  872,  872,  872,  872,  872,  872,  872,  872,  872,  872,  872,  872,  872,  872,  872,  872,  872,  872,  872,  872,  872],
    [ 939,  939,  939,  939,  939,  939,  939,  939,  939,  939,  939,  939,  939,  939,  939,  939,  939,  939,  939,  939,  939,  939,  939,  939,  939,  939,  939,  939,  939,  939,  939,  939,  939,  939,  939,  939,  939,  939,  939,  939,  939,  939,  939,  939,  939,  939,  939,  939,  939,  939],
    [1006, 1006, 1006, 1006, 1006, 1006, 1006, 1006, 1006, 1006, 1006, 1006, 1006, 1006, 1006, 1006, 1006, 1006, 1006, 1006, 1006, 1006, 1006, 1006,  939,  939,  939, 1006, 1006, 1006, 1006, 1006, 1006, 1006, 1006, 1006, 1006, 1006, 1006, 1006, 1006, 1006, 1006, 1006, 1006, 1006, 1006, 1006, 1006, 1006],
    [ 808,  808,  808,  808,  808,  808,  808,  808,  808,  808,  808,  808,  808,  808,   73,   74,   75,  808,  808,  808,  808,  808,  808,  808,  938,  939,  940,  808,  808,  808,  808,  808,  808,  808,  808,  808,  808,  808,  808,  808,  808,  808,  808,  808,  808,  808,  808,  808,  609,  610],
    [ 808,  808,  808,  808,  808,  808,  808,  808,  808,  808,  808,  808,  808,   73,  141,  141,  141,   74,   75,    6,  808,  808,  808,  808,  938,  939,  940,  808,  808,  808,  808,  808,  808,  808,  808,  808,  808,  808,  808,   73,   74,   75,  808,  808,  808,  808,  808,  609,  677,  677],
    [ 808,  808,  808,  808,  808,  808,  808,  808,  808,  808,  808,  808,   73,  141,  141,  141,  141,  141,  142,  808,  808,  808,  808,  808,  938,  939,  940,  808,    6,  808,  808,  808,  808,  808,  808,  808,  808,  808,    7,   73,  141,  141,   74,   75,  808,  808,  609,  677,  677,  677],
    [ 808,  808,  808,  808,  808,  808,  808,  808,  808,    6,  808,  808,  207,  141,  141,  141,  141,  141,  142,  808,  808,  808,  808,  808,  938,  939,  940,  808,  808,  808,  808,  808,  808,  609,  610,  611,  808,  808,  808,  140,  141,  141,  141,  142,  808,  808,  744,  677,  677,  677],
    [ 808,  808,  808,  808,  808,  808,  808,  808,  808,  808,  808,  808,  207,  207,  208,  208,  208,  208,  208,  808,  808,  808,  808,  808,  938,  939,  940,  808,  808,  808,  808,  808,    6,  676,  677,  677,  611,  808,  808,  140,  141,  141,  141,  209,  808,  808,  808,  744,  744,  744],
    [ 808,  808,  808,  808,  808,  808,  808,  808,  808,  808,  808,  609,  611,  808,  808,  808,  808,  808,  808,  808,  808,  808,  808,  808,  938,  939,  940,  808,  808,  808,  808,  808,  808,  743,  677,  677,  677,  611,  808,  207,  141,  141,  142,  808,  808,  808,  808,  808,  808,  808],
    [ 808,  808,  808,  808,  808,  808,  808,  808,  808,  808,  609,  677,  677,  611,  808,  341,  342,  342,  342,  342,  343,  808,  808,  808,  938,  939,  940,  808,  808,  808,  808,  808,  808,  808,  743,  677,  677,  678,  808,  808,  207,  208,  209,  808,  808,  808,  808,  808,  609,  610],
    [ 808,  808,  808,  808,  808,  808,  808,  808,  808,  609,  677,  677,  677,  745,  808,  408,  409,  409,  409,  409,  410,  808,  808,  808,  938,  939,  940,  808,  808,  808,  808,  808,  808,  808,  808,  743,  744,  745,  808,  808,  808,  808,  808,  808,  808,  808,  808,  609,  677,  677],
    [ 808,  808,  808,  808,  808,  808,  808,  808,  808,  676,  677,  677,  745,    6,  808,  408,  409,  409,  409,  409,  410,  808,    6,  808,  938,  939,  940,  808,  808,  808,  808,  808,  808,  808,  808,  808,  808,  808,  808,  808,  808,  808,  808,  808,  808,  808,  808,  609,  677,  677],
    [ 808,  808,  808,  808,  808,  808,  808,  808,  808,  743,  744,  745,  808,  808,  808,  408,  409,  409,  409,  409,  410,  808,  808,  808,  938,  939,  940,  808,  808,  808,  808,  808,  808,  808,  341,  342,  343,  808,  808,  808,  808,  808,  808,  808,  808,  808,  808,  676,  677,  677],
    [ 808,  808,  808,  808,  808,  808,  808,  808,  808,  808,  808,  808,  808,  808,  808,  475,  476,  476,  476,  476,  477,  808,  808,  808,  938,  939,  940,  808,  808,  808,  808,  808,  808,  808,  408,  409,  410,  808,  808,  808,  808,  808,  808,  808,  808,  808,  609,  677,  677,  677],
    [ 808,  808,  808,  808,  808,  808,  808,  808,  808,  808,  808,  808,  808,  808,  808,  808,    6,  808,  808,  808,    6,  808,  808,  808,  938,  939,  940,  808,  808,  808,  808,  808,  808,  808,  475,  476,  477,  808,  808,  808,  808,  808,  808,  808,  808,  808,  676,  677,  677,  677],
    [ 808,  808,  808,  808,  808,  808,  808,  808,  808,  808,  808,  808,  609,  610,  611,  808,  808,  808,  808,  808,  808,  808,  808,  808,  938,  939,  940,  808,  808,  808,  808,  808,  808,  808,  808,  808,  808,  808,  808,  808,  808,  808,  808,  808,  808,  609,  677,  677,  677,  677],
    [ 808,  808,  808,  808,  808,  808,  808,  808,  808,  808,  808,  609,  677,  677,  677,  610,  611,  808,  808,  808,  808,  808,  808,  808,  938,  939,  940,  808,  808,  808,  808,  808,  808,    8,  808,  808,  808,  808,  808,  808,  808,  808,  808,  808,  609,  677,  677,  677,  677,  677],
    [ 808,  808,  808,  808,  808,  808,  808,  808,  808,  808,  609,  677,  677,  677,  677,  677,  677,  610,  611,  808,  808,  808,  808,  808, 1005, 1006, 1007,  808,  808,  808,  808,  808,  808,  808,  808,  808,  808,  808,  808,  808,  808,  808,  808,  609,  677,  677,  677,  677,  677,  677]
  ],
  "couche1": [
    [  -1,   -1,   -1,   -1,   -1,   -1,   -1,   -1,   -1,   -1,   -1,   -1,   -1,   -1,   -1,   -1,   -1,   -1,   -1,   -1,   -1,   -1,   -1,   -1,   -1,   -1,   -1,   -1,   -1,   -1,   -1,   -1,   -1,   -1,   -1,   -1,   -1,   -1,   -1,   -1,   -1,   -1,   -1,   -1,   -1,   -1,   -1,   -1,   -1,   -1],
    [  -1,   -1,   -1,   -1,   -1,   -1,   -1,   -1,   -1,   -1,   -1,   -1,   -1,   -1,   -1,   -1,   -1,   -1,   -1,   -1,   -1,   -1,   -1,   -1,   -1,   -1,   -1,   -1,   -1,   -1,   -1,   -1,   -1,   -1,   -1,   -1,   -1,   -1,   -1,   -1,   -1,   -1,   -1,   -1,   -1,   -1,   -1,   -1,   -1,   -1],
    [  -1,   -1,   -1,   -1,   -1,   -1,   -1,   -1,   -1,   -1,   -1,   -1,   -1,   -1,   -1,   -1,   -1,   -1,   -1,   -1,   -1,   -1,   -1,   -1,   -1,   -1,   -1,   -1,   -1,   -1,   -1,   -1,   -1,   -1,   -1,   -1,   -1,   -1,   -1,   -1,   -1,   -1,   -1,   -1,   -1,   -1,   -1,   -1,   -1,   -1],
    [  -1,   -1,   -1,   -1,   -1,   -1,   -1,   -1,   -1,   -1,   -1,   -1,   -1,   -1,   -1,   -1,   -1,   -1,   -1,   -1,   -1,   -1,   -1,   -1,   -1,   -1,   -1,   -1,   -1,   -1,   -1,   -1,   -1,   -1,   -1,   -1,   -1,   -1,   -1,   -1,   -1,   -1,   -1,   -1,   -1,   -1,   -1,   -1,   -1,   -1],
    [  -1,   -1,   -1,   -1,   -1,  368,  369,  370,   -1,   -1,   -1,   -1,   -1,   -1,   -1,   -1,   -1,   -1,   -1,   -1,   -1,   -1,   -1,   -1,   -1,   -1,   -1,   -1,   -1,   -1,   -1,   -1,   -1,   -1,   -1,   -1,   -1,   -1,  368,  369,  370,   -1,   -1,   -1,   -1,   -1,   -1,   -1, 1053, 1054],
    [ 312,  313,  314,   -1,   -1,   -1,   -1,   -1,  368,  369,  370,  755,   -1,  304,  305,  306,  307,   -1,   -1,  368,  369,  370,  368,  369,  370,   -1,   -1,   -1,   -1,   -1,   -1,  368,  369,  370,   -1,   -1,   -1,   -1,  839,   -1,   -1,   -1,   -1,   -1,   -1,   -1,   -1,   -1,   -1,   -1],
    [  -1,   -1,   -1,   -1,   -1,   -1,   -1,  368,  369,  370,   -1,   -1,   -1,   -1,   -1,   -1,   -1,   -1,   -1,   -1,  368,  369,  370,   -1,   -1,   -1,   -1,   -1,   -1,   -1,   -1,   -1,  905,   -1,   -1,   -1,   -1,  688,   -1,   -1,   -1,   -1,   -1,   -1,  102,   -1,   -1,   -1,   -1,   -1],
    [  -1,   -1,   -1,   35,   -1,   -1,   -1,  838,   -1,   -1,   -1,   -1,   -1,   -1,   -1,   -1,   -1,   -1,  368,  369,  370,  368,  369,  370,   -1,   -1,   -1,  839,   -1,   -1,   -1,   -1,   -1,  838,   -1,   -1,   49,   -1,   -1,   -1,   -1,   -1,   -1,   -1,   -1,   -1,   -1,   -1,   -1,   -1],
    [  -1,   -1,   -1, 1053, 1054,   -1,   -1,   -1,   -1,   -1,   -1,   -1,   -1,  839,   -1,   -1,   -1,   -1,   -1,   -1,   -1,   -1,  368,  369,  370,   -1,   -1,   -1,   35,   -1,   -1,   -1,   -1,   -1,   -1,   -1,   -1,   -1,   -1,   -1,   -1,  838,   -1,   -1,   -1,   -1,  839,   -1,   -1,   -1],
    [  -1,   -1,   -1,   -1,   -1,  116,   -1,   -1,   -1,   -1,  839,   -1,   -1,   -1,   -1,   -1,   -1,   -1,   -1,  503,  504,   -1,   -1,   -1,   -1,   -1,   -1,   -1,   -1,   -1,   -1,   -1,   -1,   -1,   -1,   -1,   -1,   -1,   -1,  253,   -1,   -1,   -1,   -1,   -1,   -1,   -1,   -1,   -1,   -1],
    [  -1,  822,  823,   -1,   -1,   -1,  455,   -1,   -1,   -1,   -1,   -1, 1053, 1054,   -1,   -1,   -1,   -1,   -1,   -1,   -1,   -1,   -1,    5,   -1,   -1,   -1,   -1,   -1,   -1,   -1,  583,  584,   -1,   -1,   -1,   -1,   -1,   -1,   -1,   -1,   -1,   -1,   -1,   -1,   -1,   -1,   -1,  455,   -1],
    [  -1,   -1,   -1,   -1,   -1,   -1,   -1, 1050, 1051,  181,   -1,   -1,   -1,   -1,   -1,   -1,   -1,   -1,   -1,   -1,   -1,   -1,   -1,   -1,   -1,   -1,   -1,   -1,   -1,   -1,   -1,   -1,   -1,   -1,   -1,   -1,   -1,   -1,   -1,   -1,   -1,   -1,   -1,   -1,   -1,   -1,   -1,   -1,   -1,   -1],
    [  -1,   -1,   -1,   -1,   -1,   -1,   -1,   -1,   -1,   -1,   -1,   -1,   -1,   -1,   -1,   -1,   -1,   -1,   -1,   -1,   -1,   -1,   -1,   -1,   -1,   -1,   -1,   -1,   -1,   -1,   -1,   -1,   -1,   -1,   -1,   -1,   -1,   -1,   -1,   -1,   -1,   -1,   -1,   -1,   -1,   -1,   -1,   -1,   -1,   -1],
    [  -1,   -1,   -1,   -1,   -1,   -1,   -1,   -1,   -1,   -1,   -1,   -1,   -1,   -1,   -1,   -1,   -1,   -1,   -1,   -1,   -1,   -1,   -1,   -1,   -1,   -1,   -1,   -1,   -1,   -1,   -1,   -1,   -1,   -1,   -1,   -1,   -1,   -1,   -1,   -1,   -1,   -1,   -1,   -1,   -1,   -1,   -1,   -1,   -1,   -1],
    [  -1,   -1,   -1,   -1,   -1,   -1,   -1,   -1,   -1,   -1,   -1,   -1,   -1,   -1,   -1,   -1,   -1,   -1,   -1,   -1,   -1,   -1,   -1,   -1,   -1,   -1,   -1,   -1,   -1,   -1,   -1,   -1,   -1,   -1,   -1,   -1,   -1,   -1,   -1,   -1,   -1,   -1,   -1,   -1,   -1,   -1,   -1,   -1,   -1,   -1],
    [  -1,   -1,   -1,   -1,   -1,   -1,   -1,   -1,   -1,   -1,   -1,   -1,   -1,   -1,   -1,   -1,   -1,   -1,   -1,   -1,   -1,   -1,   -1,   -1,   -1,   -1,   -1,   -1,   -1,   -1,   -1,   -1,   -1,   -1,   -1,   -1,   -1,   -1,   -1,   -1,  304,  305,  306,  307,   -1,   -1,   -1,   -1,   -1,   -1],
    [  -1,   -1,   -1,   -1,   -1,   -1,   -1,   -1,   -1,   -1,  755,   -1,   -1,   -1,  253,   -1,   -1,   -1,   -1,   -1,   -1,   -1,   -1,   -1,   -1,   -1,   -1,  583,  584,   -1,   -1,   -1,   -1,   -1,  455,   -1,   -1,   -1,   -1,   -1,   -1,   -1,   -1,   -1,   -1,   -1,   -1,   -1,   -1,   -1],
    [  -1,   -1,   -1,   -1,   -1,  839,   -1,   -1,   -1,   -1,   -1,   -1,   -1,   -1,   -1,   -1,   -1,   -1,   -1,   -1,  304,  305,  306,  307,   -1,   -1,   -1,   -1,   -1,   -1,   -1,   -1,   -1,   -1,   -1,   -1,   -1,   -1,   -1,   -1,   -1,   -1,   -1,   -1,   -1,   -1,   -1,   -1,   -1,   -1],
    [  -1,   -1,   -1,   -1,   -1,   -1,   -1,  304,  305,  306,  307,   -1,   -1,   -1,   -1,   -1,   -1,   -1,   -1,   -1,   -1,   -1,   -1,   -1,   -1,   -1,   -1,   -1,   -1,   -1,   -1,   -1,   -1,   -1,   -1,   -1,  102,   -1,   -1,   -1,   -1,   -1,   -1,  503,  504,   -1,   -1,   -1,   -1,   -1],
    [  -1,   -1,   -1,  755,   -1,   -1,   -1,  387,   -1,   -1,   -1,   -1,   -1,  181,   -1,   -1,   -1,   -1,   -1,   -1,   -1,   -1,   -1,   -1,   -1,   -1,   -1,   -1,   -1,   -1,   -1,   -1,   -1,   -1,   -1,   -1,   -1,   -1,   -1,   -1,   -1,   -1,   -1,   -1,   -1,   -1,   -1,   -1,   -1,   -1],
    [  -1, 1050, 1051,   -1,   -1,   -1,   -1,   -1,   -1,   -1,   -1,   -1,   -1,   -1,   -1,   -1,   -1,   -1,   -1,   -1,   -1,   -1,   -1,   -1,   -1,   -1,   -1,   -1,   -1,   -1,   -1,  839,   -1,   -1,   -1,   -1,   -1,   -1,   -1,  308,  309,  310,  311,   -1,   -1,   -1,   -1,   -1,   -1,   -1],
    [  -1,   -1,   -1,   -1,   -1,   -1,   -1,   -1,   -1,   -1,   -1,   -1,   -1,   -1,   -1,   -1,   -1,   -1,   -1,   -1,   -1,   -1, 1050, 1051,   -1,   -1,   -1,   -1,   -1,   -1,   -1,   -1,   -1,   -1,   -1,   -1,   -1,   -1,  838,   -1,   -1,   -1,   -1,   -1,  838,   -1,   -1,   -1,   -1,   -1],
    [  -1,   -1,   -1,   -1,   -1,   -1,   -1,   -1,   -1,  838,   -1,   -1,   -1,   -1,   -1,   -1,  688,   -1,   -1,   -1,   -1,   -1,   -1,   -1,   -1,   -1,   -1,   -1,   -1,   -1,  755,   -1,   -1,   -1,   -1,   -1,   -1,   -1,   -1,   -1,   -1,   -1,   -1,   -1,   -1,   -1,   -1,   -1,   -1,   -1],
    [  -1,   -1,   -1,  503,  504,   -1,   -1,   -1,   -1,   -1,   -1,   -1, 1050, 1051,   -1,   -1,   -1,   -1,  893,   -1,   -1,   -1,   -1,   -1,   -1,   -1,   -1,   -1,   -1,   -1,   -1,   -1,   -1,   -1,   -1,   -1,   -1,   -1,   48,   -1,   -1,   -1,   -1,   -1,   -1,   -1,   -1,   -1,   -1,   -1],
    [  -1,   -1,   -1,   -1,   -1,   -1,   -1,  905,   -1,   -1,   -1,   -1,   -1,   -1,   -1,   -1,  905,   -1,   -1,   -1,  905,   -1,   -1,   -1,   -1,   -1,   -1,   -1,   -1,   -1,   -1,   -1,   -1,   -1,   -1,   -1,   -1,   -1,   -1,   -1,   -1,   -1,  839,   -1,   -1,   -1,  783,  784,   -1,   -1],
    [  -1,  583,  584,   -1,   -1,   -1,   -1,   -1,   -1,   -1,   -1,   -1,   -1,   -1,   -1,   -1,   -1,   -1,   -1,   -1,  838,   -1,   -1,   -1,   -1,   -1,   -1,   -1,   -1,   -1,  839,   -1,   -1,   -1,   -1,  893,   -1,   -1,   -1,   -1,   -1,   -1,   -1,   -1,   -1,   -1,   -1,   -1,   -1,   -1],
    [  -1,   -1,   -1,   -1,   -1,   -1,   -1,   -1,   -1,   -1,   -1,   -1,   -1,  839,   -1,   -1,   -1,  313,   -1,   -1,   -1,   -1,   -1,   -1,   -1,   -1,   -1,   -1,   -1,   -1,   -1,   -1,   -1,   -1,   -1,   -1,   -1,  102,   -1,   -1,   -1,   -1,   -1,   -1,   -1,   -1,   -1,   -1,   -1,   -1],
    [  -1,   -1,   -1,  554,   -1,   -1,  455,   -1,   -1,   -1,   -1,   -1,   -1,   -1,   -1,   -1,   -1,   -1,   -1,   -1,   -1,   -1,   -1,   -1,   -1,   -1,   -1,   -1,   -1,   -1,  253,   -1,   -1,   -1,   -1,   -1,   -1,   -1,   -1,   -1,   -1,  304,  305,  306,  307,   -1,   -1,   -1,   -1,   -1],
    [  -1,   -1,   -1,   -1,   -1,   -1,   -1,   -1,   -1,   -1,   -1,   -1,   -1,   -1,   -1,   -1,   -1,   -1,   -1,   -1,   -1, 1050, 1051,   -1,   -1,   -1,   -1,   -1,   -1,   -1,   -1,   -1,   -1,   -1,  455,   -1,   -1,   -1, 1050, 1051,   -1,   -1,   -1,   -1,   -1,   -1,   -1,   -1,   -1,   -1],
    [  -1,   -1,   -1,   -1,   -1,   -1,   -1,  783,  784,   -1,   -1,   -1,   -1,   -1,   -1,   -1,   -1,   -1,   -1,   -1,   -1,   -1,   -1,   -1,   -1,   -1,   -1,   -1,   -1,   -1,   -1,   -1,   -1,   -1,   -1,   -1,   -1,   -1,   -1,   -1,   -1,   -1,   -1,   -1,   -1,   -1,   -1,   -1,   -1,   -1]
  ],
  "couche2": [
    [  -1,   -1,   -1,   -1,   -1,   -1,   -1,   -1,   -1,   -1,   -1,   -1,   -1,   -1,   -1,   -1,   -1,   -1,   -1,   -1,   -1,   -1,   -1,   -1,   -1,   -1,   -1,   -1,   -1,   -1,   -1,   -1,   -1,   -1,   -1,   -1,   -1,   -1,   -1,   -1,   -1,   -1,   -1,   -1,   -1,   -1,   -1,   -1,   -1,   -1],
    [  -1,   -1,   -1,   -1,   -1,   -1,   -1,   -1,   -1,   -1,   -1,   -1,   -1,   36,   37,   38,   39,   -1,   -1,   -1,   -1,   -1,   -1,   -1,   -1,   -1,   -1,   -1,   -1,   -1,   -1,   -1,   -1,   -1,   -1,   -1,   -1,   -1,   -1,   -1,   -1,   -1,   -1,   -1,   -1,   -1,   -1,   -1,   -1,   -1],
    [  -1,   -1,   -1,   -1,   -1,   -1,   -1,   -1,   -1,   -1,   -1,   -1,   -1,  103,  104,  105,  106,   -1,   -1,   -1,   -1,   -1,   -1,   -1,   -1,   -1,   -1,   -1,   -1,   -1,   -1,   -1,   -1,   -1,   -1,   -1,   -1,   -1,   -1,   -1,   -1,   -1,   -1,   -1,   -1,   -1,   -1,   -1,   -1,   -1],
    [  -1,   -1,   -1,   -1,   -1,   -1,   -1,   -1,   -1,   -1,   -1,   -1,   -1,  170,  171,  172,  173,   -1,   -1,   -1,   -1,   -1,   -1,   -1,   -1,   -1,   -1,   -1,   -1,   -1,   -1,   -1,   -1,   -1,   -1,   -1,   -1,   -1,   -1,   -1,   -1,   -1,   -1,   -1,   -1,   -1,   -1,   -1,   -1,   -1],
    [  -1,   -1,   -1,   -1,   -1,   -1,   -1,   -1,   -1,   -1,   -1,   -1,   -1,  237,  238,  239,  240,   -1,   -1,   -1,   -1,   -1,   -1,   -1,   -1,   -1,   -1,   -1,   -1,   -1,   -1,   -1,   -1,   -1,   -1,   -1,   -1,   -1,   -1,   -1,   -1,   -1,   -1,   -1,   -1,   -1,   -1,   -1,   -1,   -1],
    [  -1,   -1,   -1,   -1,   -1,   -1,   -1,   -1,   -1,   -1,   -1,   -1,   -1,   -1,   -1,   -1,   -1,   -1,   -1,   -1,   -1,   -1,   -1,   -1,   -1,   -1,   -1,   -1,   -1,   -1,   -1,   -1,   -1,   -1,   -1,   -1,   -1,   -1,   -1,   -1,   -1,   -1,   -1,   -1,   -1,   -1,   -1,   -1,   -1,   -1],
    [  -1,   -1,   -1,   -1,   -1,   -1,   -1,   -1,   -1,   -1,   -1,   -1,   -1,   -1,   -1,   -1,   -1,   -1,   -1,   -1,   -1,   -1,   -1,   -1,   -1,   -1,   -1,   -1,   -1,   -1,  314,  315,  316,  317,   -1,   -1,   -1,   -1,   -1,   -1,   -1,   -1,   -1,   -1,   -1,   -1,   -1,   -1,   -1,   -1],
    [  -1,   -1,   -1,   -1,   -1,   -1,   -1,   -1,   -1,   -1,   -1,   -1,   -1,   -1,   -1,   -1,   -1,   -1,   -1,   -1,   -1,   -1,   -1,   -1,   -1,   -1,   -1,   -1,   -1,   -1,  381,  382,  383,  384,   -1,   -1,   -1,   -1,   -1,   -1,   -1,   -1,   -1,   -1,   -1,   -1,   -1,   -1,   -1,   -1],
    [  -1,   -1,   -1,   -1,   -1,   -1,  848,  849,  850,  851,   -1,   -1,   -1,   -1,   -1,   -1,   -1,   -1,   -1,  436,  437,   -1,   -1,   -1,   -1,   -1,   -1,   -1,   -1,   -1,  448,  449,  450,  451,   -1,   -1,   -1,   -1,   -1,   -1,   -1,   -1,   -1,   -1,   -1,   -1,   -1,   -1,   -1,   -1],
    [  -1,   -1,   -1,   -1,   -1,   -1,  915,  916,  917,  918,   -1,   -1,   -1,   -1,   -1,   -1,   -1,   -1,   -1,   -1,   -1,   -1,   -1,   -1,   -1,   -1,   -1,   -1,   -1,   -1,  515,  516,  517,  518,   -1,   -1,   -1,   -1,   -1,   -1,   -1,   -1,   -1,   -1,   -1,   -1,   -1,   -1,   -1,   -1],
    [  -1,   -1,   -1,   -1,   -1,   -1,  982,  983,  984,  985,   -1,   -1,   -1,   -1,   -1,   -1,   -1,   -1,   -1,   -1,   -1,   -1,   -1,   -1,   -1,   -1,   -1,   -1,   -1,   -1,   -1,   -1,   -1,   -1,   -1,   -1,   -1,   -1,   -1,   -1,   -1,   -1,   -1,   -1,   -1,   -1,   -1,   -1,   -1,   -1],
    [  -1,   -1,   -1,   -1,   -1,   -1,   -1,   -1,   -1,   -1,   -1,   -1,   -1,   -1,   -1,   -1,   -1,   -1,   -1,   -1,   -1,   -1,   -1,   -1,   -1,   -1,   -1,   -1,   -1,   -1,   -1,   -1,   -1,   -1,   -1,   -1,   -1,   -1,   -1,   -1,   36,   37,   38,   39,   -1,   -1,   -1,   -1,   -1,   -1],
    [  -1,   -1,   -1,   -1,   -1,   -1,   -1,   -1,   -1,   -1,   -1,   -1,   -1,   -1,   -1,   -1,   -1,   -1,   -1,   -1,   -1,   -1,   -1,   -1,   -1,   -1,  314,  315,  316,  317,   -1,   -1,   -1,   -1,   -1,   -1,   -1,   -1,   -1,   -1,  103,  104,  105,  106,   -1,   -1,   -1,   -1,   -1,   -1],
    [  -1,   -1,   -1,   -1,   -1,   -1,   -1,   -1,   -1,   -1,   -1,   -1,   -1,   -1,   -1,   -1,   -1,   -1,   -1,   -1,   36,   37,   38,   39,   -1,   -1,  381,  382,  383,  384,   -1,   -1,   -1,   -1,   -1,   -1,   -1,   -1,   -1,   -1,  170,  171,  172,  173,   -1,   -1,   -1,   -1,   -1,   -1],
    [  -1,   -1,   -1,   -1,   -1,   -1,   -1,   36,   37,   38,   39,   -1,   -1,   -1,   -1,   -1,   -1,   -1,   -1,   -1,  103,  104,  105,  106,   -1,   -1,  448,  449,  450,  451,   -1,   -1,   -1,   -1,   -1,   -1,   -1,   -1,   -1,   -1,  237,  238,  239,  240,   -1,   -1,   -1,   -1,   -1,   -1],
    [  -1,   -1,   -1,   -1,   -1,   -1,   -1,  103,  104,  105,  106,   -1,   -1,   -1,   -1,   -1,   -1,   -1,   -1,   -1,  170,  171,  172,  173,   -1,   -1,  515,  516,  517,  518,   -1,   -1,   -1,   -1,   -1,   -1,   -1,   -1,   -1,   -1,   -1,   -1,   -1,   -1,   -1,   -1,   -1,   -1,   -1,   -1],
    [  -1,   -1,   -1,   -1,   -1,   -1,   -1,  170,  171,  172,  173,   -1,   -1,   -1,   -1,   -1,   -1,   -1,   -1,   -1,  237,  238,  239,  240,   -1,   -1,   -1,   -1,   -1,   -1,   -1,   -1,   -1,   -1,   -1,   -1,   -1,   -1,   -1,   40,   41,   42,   43,   -1,   -1,   -1,   -1,   -1,   -1,   -1],
    [ 848,  849,  850,  851,   -1,   -1,   -1,  237,  238,  239,  240,   -1,   -1,   -1,   -1,   -1,   -1,   -1,   -1,   -1,   -1,   -1,   -1,   -1,   -1,   -1,   -1,   -1,   -1,   -1,   -1,   -1,   -1,   -1,   -1,   -1,   -1,   -1,   -1,  107,  108,  109,  110,  436,  437,   -1,   -1,   -1,   -1,   -1],
    [ 915,  916,  917,  918,   -1,   -1,   -1,   -1,   -1,   -1,   -1,   -1,   -1,   -1,   -1,   -1,   -1,   -1,   -1,   -1,   -1,  848,  849,  850,  851,   -1,   -1,   -1,   -1,   -1,   -1,   -1,   -1,   -1,   -1,   -1,   -1,   -1,   -1,  174,  175,  176,  177,   -1,   -1,   -1,   -1,   -1,   -1,   -1],
    [ 982,  983,  984,  985,   -1,   -1,   -1,   -1,   -1,   -1,   -1,   -1,   -1,   -1,   -1,   -1,   -1,   -1,   -1,   -1,   -1,  915,  916,  917,  918,   -1,   -1,   -1,   -1,   -1,   -1,   -1,   -1,   -1,   -1,   -1,   -1,   -1,   -1,  241,  242,  243,  244,   -1,   -1,   -1,   -1,   -1,   -1,   -1],
    [  -1,   -1,   -1,   -1,   -1,   -1,   -1,   -1,   -1,   -1,   -1,  848,  849,  850,  851,   -1,   -1,   -1,   -1,   -1,   -1,  982,  983,  984,  985,   -1,   -1,   -1,   -1,   -1,   -1,   -1,   -1,   -1,   -1,   -1,   -1,   -1,   -1,   -1,   -1,   -1,   -1,   -1,   -1,   -1,   -1,   -1,   -1,   -1],
    [ 314,  315,  316,  317,   -1,   -1,   -1,   -1,   -1,   -1,   -1,  915,  916,  917,  918,   -1,   -1,   -1,   -1,   -1,   -1,   -1,   -1,   -1,   -1,   -1,   -1,   -1,   -1,   -1,   -1,   -1,   -1,   -1,   -1,   -1,   -1,   -1,   -1,   -1,   -1,   -1,   -1,   -1,   -1,   -1,   -1,   -1,   -1,   -1],
    [ 381,  382,  383,  384,   -1,   -1,   -1,   -1,   -1,   -1,   -1,  982,  983,  984,  985,   -1,   44,   45,   46,   -1,   -1,   -1,   -1,   -1,   -1,   -1,   -1,   -1,   -1,   -1,   -1,   -1,   -1,   -1,   -1,   -1,   -1,   -1,   -1,   -1,   -1,   -1,   -1,   -1,   -1,   -1,  649,  650,   -1,   -1],
    [ 448,  449,  450,  451,   -1,   -1,   -1,   -1,   -1,   -1,   -1,   -1,   -1,   -1,   -1,   -1,  111,  112,  113,   -1,   -1,   -1,   -1,   -1,   -1,   -1,   -1,   -1,   -1,   -1,   -1,   -1,   -1,   -1,   -1,   -1,   -1,   -1,   -1,   -1,   -1,   36,   37,   38,   39,   -1,  716,  717,   -1,   -1],
    [ 515,  516,  517,  518,   -1,   -1,   -1,   -1,   -1,   -1,   -1,   -1,   -1,   -1,   -1,   -1,  178,  179,  180,   -1,   -1,   -1,   -1,   -1,   -1,   -1,   -1,   -1,   -1,   -1,   -1,   -1,   -1,   -1,   -1,   -1,   -1,   -1,   -1,   -1,   -1,  103,  104,  105,  106,   -1,   -1,   -1,   -1,   -1],
    [  -1,   -1,   -1,   -1,   -1,   -1,   -1,   -1,   -1,   -1,   -1,   -1,   -1,   -1,   -1,   -1,  245,  246,  247,   -1,  848,  849,  850,  851,   -1,   -1,   -1,   -1,   -1,   -1,   -1,   -1,   -1,   -1,   -1,   -1,   -1,   -1,  852,  853,   -1,  170,  171,  172,  173,   -1,   -1,   -1,   -1,   -1],
    [  -1,   -1,   -1,   -1,   -1,   -1,   -1,   -1,   -1,   -1,   -1,   -1,   -1,   -1,   -1,   -1,   -1,   -1,   -1,   -1,  915,  916,  917,  918,   -1,   -1,   -1,   -1,   -1,   -1,   -1,   -1,   -1,   -1,   -1,   -1,   -1,   -1,  919,  920,   -1,  237,  238,  239,  240,   -1,   -1,   -1,   -1,   -1],
    [  -1,   -1,   -1,   -1,   -1,   -1,   -1,  649,  650,   -1,   -1,   -1,   -1,   -1,   -1,   -1,   -1,   -1,   -1,   -1,  982,  983,  984,  985,   -1,   -1,   -1,   -1,   -1,   -1,   -1,   -1,   -1,   -1,   -1,   -1,   -1,   -1,  986,  987,   -1,   -1,   -1,   -1,   -1,   -1,   -1,   -1,   -1,   -1],
    [  -1,   -1,   -1,   -1,   -1,   -1,   -1,  716,  717,   -1,   -1,   -1,   -1,   -1,   -1,   -1,   -1,   -1,   -1,   -1,   -1,   -1,   -1,   -1,   -1,   -1,   -1,   -1,   -1,   -1,   -1,   -1,   -1,   -1,   -1,   -1,   -1,   -1,   -1,   -1,   -1,   -1,   -1,   -1,   -1,   -1,   -1,   -1,   -1,   -1],
    [  -1,   -1,   -1,   -1,   -1,   -1,   -1,   -1,   -1,   -1,   -1,   -1,   -1,   -1,   -1,   -1,   -1,   -1,   -1,   -1,   -1,   -1,   -1,   -1,   -1,   -1,   -1,   -1,   -1,   -1,   -1,   -1,   -1,   -1,   -1,   -1,   -1,   -1,   -1,   -1,   -1,   -1,   -1,   -1,   -1,   -1,   -1,   -1,   -1,   -1]
  ]
}