  11   11   11   11   11   11   11   11   11   11   11   11   11   11   11   11   11   11   11   11 
  41   41   41   41   41   41   41   41   41   41   41   41   41   41   41   41   41   41   41   41 
  71   71   71   71   71   71   71   71   71   71   71   71   71   71   71   71   71   71   71   71 
 423  364  364  394   59  394  394  273  274  275  394  394  394  394  394  273  274  275  394  394 
 387  388  389  364   59  364  364  303  304  305  364  364  364  364  364  303  304  305  364  364 
 423  364  364  364   59  273  274  276  304  277  274  274  274  274  274  304  304  304  275  364 
 423  364  364  364   59  303  304  304  304  304  304  304  304  304  304  304  304  304  305  364 
 423  364  364  364   59  333  334  334  334  334  334  334  334  334  334  334  334  334  335  364 
 387  388  389  364   89  364  364  364  364  364  364  364  364  364  364  364  364  364  364  364 
 423  364  364  364  364  364  364  364  364   27   26   27  364  364  364  364  364  364  364  364 