{
  "largeur": 20,
  "hauteur": 10,
  "chipset": "BZ.png",
  "musique": "Castle_1.mp3",
  "couche0": [
    [  11,   11,   11,   11,   11,   11,   11,   11,   11,   11,   11,   11,   11,   11,   11,   11,   11,   11,   11,   11],
    [  41,   41,   41,   41,   41,   41,   41,   41,   41,   41,   41,   41,   41,   41,   41,   41,   41,   41,   41,   41],
    [  71,   71,   71,   71,   71,   71,   71,   71,   71,   71,   71,   71,   71,   71,   71,   71,   71,   71,   71,   71],
    [ 423,  364,  364,  394,   59,  394,  394,  273,  274,  275,  394,  394,  394,  394,  394,  273,  274,  275,  394,  394],
    [ 387,  388,  389,  364,   59,  364,  364,  303,  304,  305,  364,  364,  364,  364,  364,  303,  304,  305,  364,  364],
    [ 423,  364,  364,  364,   59,  273,  274,  276,  304,  277,  274,  274,  274,  274,  274,  304,  304,  304,  275,  364],
    [ 423,  364,  364,  364,   59,  303,  304,  304,  304,  304,  304,  304,  304,  304,  304,  304,  304,  304,  305,  364],
    [ 423,  364,  364,  364,   59,  333,  334,  334,  334,  334,  334,  334,  334,  334,  334,  334,  334,  334,  335,  364],
    [ 387,  388,  389,  364,   89,  364,  364,  364,  364,  364,  364,  364,  364,  364,  364,  364,  364,  364,  364,  364],
    [ 423,  364,  364,  364,  364,  364,  364,  364,  364,   27,   26,   27,  364,  364,  364,  364,  364,  364,  364,  364]
  ],
  "couche1": [
    [  -1,   -1,   -1,   -1,   -1,   -1,   -1,   -1,   -1,   -1,   -1,   -1,   -1,   -1,   -1,   -1,   -1,   -1,   -1,   -1],
    [  -1,   -1,   -1,  175,  176,   -1,   -1,   -1,  296,   -1,   -1,   20,   21,   -1,   -1,   -1,   -1,   -1,   -1,   -1],
    [  -1,   -1,   -1,   -1,   29,   -1,   -1,   -1,  326,   -1,   -1,   50,   51,   -1,   -1,   -1,   -1,   -1,   -1,   -1],
    [  -1,   -1,   -1,   -1,   -1,   -1,   -1,   -1,   -1,   -1,   -1,   80,   81,   -1,  265,   -1,   -1,   -1,   -1,   -1],
    [  -1,   -1,   -1,   -1,   -1,   -1,  218,   -1,   -1,   -1,   -1,   -1,   -1,   -1,   -1,   -1,   -1,   -1,   -1,  218],
    [  -1,   -1,   -1,   -1,  299,   -1,   -1,   -1,   -1,   -1,   -1,   -1,   -1,   -1,   -1,   -1,   -1,   -1,   -1,   -1],
    [  -1,   -1,   -1,   -1,   -1,   -1,   -1,   -1,   -1,   -1,   -1,  297,  144,  269,   -1,   -1,   -1,   -1,   -1,   -1],
    [  -1,   -1,   -1,   -1,   -1,   -1,   -1,   -1,   -1,   -1,   -1,   -1,   -1,   -1,   -1,   -1,   -1,   -1,   -1,   -1],
    [  -1,   -1,   -1,   -1,   -1,   -1,   -1,   -1,   -1,   -1,   -1,   -1,   -1,   -1,   -1,   -1,   -1,   -1,   -1,   -1],
    [  -1,   -1,   -1,   -1,   -1,   -1,  218,   -1,  414,   -1,   -1,   -1,   -1,   -1,   -1,   -1,   82,   83,   84,  218]
  ],
  "couche2": [
    [  -1,   -1,   -1,   -1,   -1,   -1,   -1,   -1,   -1,   -1,   -1,   -1,   -1,   -1,   -1,   -1,   -1,   -1,   -1,   -1],
    [  -1,   -1,   -1,   -1,   -1,   -1,  128,   -1,   -1,   -1,   -1,   20,   21,   -1,   -1,   -1,   -1,   -1,   -1,  128],
    [ 327,  328,  329,   -1,   -1,   -1,  158,   -1,   -1,   -1,   -1,   50,   51,   -1,   -1,   -1,   -1,   -1,   -1,  158],
    [ 357,  358,  359,   -1,   -1,   -1,  188,   -1,   -1,   -1,   -1,   -1,   -1,   -1,   -1,   -1,   -1,   -1,   -1,  188],
    [  -1,   -1,   -1,   -1,   -1,   -1,   -1,   -1,   -1,   -1,   -1,   -1,   -1,   -1,   -1,   -1,   -1,   -1,   -1,   -1],
    [  -1,   -1,   -1,   -1,   -1,   -1,   -1,   -1,   -1,   -1,   -1,  237,  114,  239,   -1,   -1,   -1,   -1,   -1,   -1],
    [ 327,  328,  329,   -1,   -1,   -1,  128,   -1,   -1,   -1,   -1,   -1,  238,   -1,   -1,   -1,   -1,   -1,   -1,  128],
    [ 357,  358,  359,   -1,   -1,   -1,  158,   -1,   -1,   -1,   -1,   -1,   -1,   -1,   -1,   -1,   22,   23,   24,  158],
    [  -1,   -1,   -1,   -1,   -1,   -1,  188,   -1,   -1,   -1,   -1,   -1,   -1,   -1,   -1,   -1,   52,   53,   54,  188],
    [  -1,   -1,   -1,   -1,   -1,   -1,   -1,   -1,   -1,   -1,   -1,   -1,   -1,   -1,   -1,   -1,   -1,   -1,   -1,   -1]
  ]
}