  -1   -1   -1   -1   -1   -1   -1   -1   -1   -1   -1   -1   -1   -1   -1   -1   -1   -1   -1   -1   -1   -1   -1   -1   -1   -1   -1   -1   -1   -1   -1   -1   -1   -1   -1   -1   -1   -1   -1   -1   -1   -1   -1   -1   -1   -1   -1   -1   -1   -1 
  -1   -1   -1   -1   -1   -1   -1   -1   -1   -1   -1  688   -1   -1   -1   -1   -1   -1   -1  838   -1   -1   -1   -1   -1   -1   -1   -1   -1   -1   -1   -1   -1   -1   -1   -1   -1   -1   -1  294   -1  230   -1   -1   -1   -1   -1   -1   -1   -1 
  -1   -1  554   -1   -1   -1   -1   -1   -1   -1   -1   -1   -1  905   -1   -1   -1  181   -1   -1   -1   -1  116   -1   -1   -1   -1   -1   -1   -1   -1   -1   -1   -1   -1   -1   -1   -1   -1   -1   -1   -1   -1   -1   -1   -1  554   -1   -1   -1 
  -1   -1   -1   -1   -1   -1   -1   -1   -1   -1  893   -1   -1   -1   -1   -1   -1   -1   -1   -1  688   -1   -1  837   -1   -1   -1   -1   -1   -1   -1   -1   -1   -1  838   -1   -1   -1   -1   -1   -1   -1   -1   -1   -1   -1   -1   -1   -1   -1 
  -1   -1   -1   -1  181   -1   -1   -1   -1   -1   -1   -1   -1   -1   -1   -1   -1   -1   -1   -1   -1   -1   -1   -1   -1   -1   -1   -1   -1   -1   -1   -1  729   -1   -1   -1   -1   -1   -1   -1  163   -1   -1  162   -1   -1   -1   -1   -1   -1 
  -1   -1   -1   -1   -1   -1   -1   -1  729   -1   -1   -1   -1   -1   -1   -1   -1   -1   -1   -1   -1   -1   -1   -1   -1   -1   -1   -1   -1  838   -1   -1   -1   -1   -1   -1   -1   -1   -1   -1   -1   -1   -1   -1   -1   -1   -1   -1   -1   -1 
  -1   -1   -1   -1   -1   -1   -1   -1   -1   -1   -1   -1   -1   -1   -1   -1   -1   -1   -1   -1   -1   -1   -1   -1   -1   -1   -1   -1   -1   -1  688   -1   -1   -1   -1   -1   -1   -1   -1   -1   -1   -1  228   -1   -1   -1   -1   -1   -1   -1 
  -1   -1  729   -1   -1   -1   -1   -1   -1   -1   -1   -1   -1   -1   -1   -1   -1   -1   -1   -1   -1   -1   -1   -1   -1   -1   35   -1   -1  838   -1   -1   -1   -1  688   -1   -1   -1   -1   -1   -1   -1   -1   -1   -1   -1   -1   -1   -1   -1 
  -1   -1   -1   -1   -1   -1   -1  215  215  215  215  215  215  215  215  215  215   -1   -1   -1   -1   -1   -1   -1   -1   -1   -1   -1   -1  893   -1   -1   -1   -1   -1   -1   -1   -1   -1   -1   -1   -1   -1   -1   -1   -1   -1   -1   -1   -1 
  -1   -1   -1   -1   -1   -1   -1  216  216  216  216  216  216  216  216  216  216   -1   -1   -1   -1   -1   -1   -1  756   -1   -1   -1   -1   -1   -1   -1   -1   -1   -1   -1   -1   -1    1    1   -1    1    1    1   -1   -1   -1   -1   -1   -1 
  -1   -1   -1   -1   -1   -1   -1  216  216  216  216  216  216  216   15   16   17   -1   -1   -1   -1   -1   -1   -1   -1   -1   -1   -1  215  215  215  215  215  215  215  215   -1   -1   -1   -1   -1   -1   -1   -1   -1   -1   -1   -1   -1   -1 
  -1   -1   -1   -1   -1   -1   -1  216  216  216  216  216  216  216   82  351   84   50   -1   -1   -1   -1   -1   -1   -1   -1   -1   -1  216  216  216  216  216  216  216  216   -1   -1    2    2    2    0    0    0   -1   -1   -1   -1   -1   -1 
  -1   -1   -1   -1   -1   -1   -1   15   16   16   16   16   16   17  149  150  151  117   -1   -1   -1   -1   -1   -1   -1   -1   -1   -1   12   13   13   13   13   13   13   14   -1   -1   -1   -1   -1   -1   -1   -1   -1   -1   -1   -1   -1   -1 
  -1   -1   -1   -1   -1   -1   -1   82  352   83   83   83   83   84   -1   -1  775   -1   -1   -1   -1   -1   -1   -1   -1   -1   -1   -1   79   80   80   80   80  556  557   81   -1   -1   68   68   69   69   68   68   -1   -1   -1   -1   -1   -1 
  -1   -1   -1   -1   -1   -1   -1  149  150  150  150  150  150  151   -1   -1   -1   -1   -1   -1   -1   -1   -1   -1   -1   -1   -1   -1  146  147  147  147  147  623  624  148   -1   -1   -1   -1   -1   -1   -1  897  899  900   -1   -1   -1   -1 
  -1   -1   -1   -1  120   53   53   -1   -1   -1   -1   -1   -1   -1  755   -1   -1   -1   -1   -1   -1   -1   -1   -1   -1   -1   -1   -1   -1   -1  548   -1   -1   -1   -1   -1   -1   -1   -1   -1   -1   -1   -1  964  966  967   -1   -1   -1   -1 
  -1  137  138   -1  187   -1   -1   -1   -1   -1   -1   -1   -1   -1   -1   -1   -1   -1   -1   -1   -1   -1   -1   -1   -1   -1   -1   -1   -1   -1   -1   -1   -1   -1   -1   -1   -1   -1   -1   -1   -1   -1   -1 1032 1033 1034   -1   -1   -1   -1 
  -1  204  205   -1  187   -1   -1  121   -1   -1   -1   -1   -1   -1   -1   -1   -1   -1   -1   -1   -1   -1   -1   -1   -1   -1   -1   -1   -1   -1   -1   -1   -1   -1   -1   -1   -1   -1   -1   -1   -1   -1   -1   -1 1031 1031   -1   -1   -1   -1 
  -1  137  138   -1  254   53   53  255   -1   -1   -1   -1   -1   -1   -1   -1   -1   -1   -1   -1   -1   -1   -1   -1   -1   -1   -1   -1   -1   -1   -1   -1   -1   -1   -1   -1   -1   -1   -1   -1   -1   -1   -1   -1   -1   -1   -1   -1   -1   -1 
  -1  204  205   -1   -1   -1   -1   -1   -1   -1   -1   -1   -1   -1   -1   -1   -1   -1   -1   -1   -1   -1   -1   -1   -1   -1   -1   -1  729   -1   -1   -1   -1   -1   -1   -1   -1   -1  215  215  215  215  215  215  215   -1   -1   -1   -1   -1 
  -1  137  138   -1   -1   -1   -1   -1   -1   -1   -1   -1   -1   -1   -1   -1   -1   -1   -1   -1   -1   -1   -1   -1   -1   -1   -1   -1   -1   -1   -1   -1   -1   -1   -1   -1   -1   -1  216  216  216  216  216  216  216   -1   -1   -1   -1   -1 
  -1  204  205   -1   -1   -1   -1   -1   -1   -1   -1   -1   -1   -1   -1   -1   -1   -1   -1   -1   -1   -1   -1   -1   -1   -1   -1   -1   -1   -1   -1   -1   -1   -1   -1   -1  688   -1  216  216  216  216  216  216  216   -1   -1   -1   -1   -1 
  -1   -1   -1   -1   -1   -1   -1   -1   -1   -1  893   -1   -1   -1   -1   -1   -1   -1   -1   -1   -1   -1   -1   -1   -1   -1   -1   -1  893   -1   -1   -1   -1   -1   -1   -1   -1   -1   12   13   13   13   13   13   14   -1   -1   -1   -1   -1 
  -1   -1  215  215  215  215  215  215   -1   -1   -1   -1   -1   -1   -1   -1   -1   -1   -1   -1   -1   -1   -1   -1   -1   -1   -1   -1   -1   -1   -1   -1   -1   -1   -1   -1   -1   -1   79   80   80   80   80  350   81  586   -1   -1   -1   -1 
  -1   -1  216  216  216  216  216  216   -1   -1   -1   -1   -1   -1   -1   -1   -1   -1   -1   -1   -1   -1   -1   -1   -1   -1   -1   -1   -1   -1   -1   -1   -1   -1   -1  688   -1   -1  146  147  147  147  147  147  148  653  688   -1  838   -1 
  -1   -1  216  216  216  216  216  216  554   -1   -1   -1   -1   -1   -1   -1   -1   -1   -1   -1   -1   -1   -1   -1   -1   -1   -1   -1   -1   -1   -1   -1   -1   -1   -1   -1   -1   -1  775   -1   -1   -1   -1   -1   -1   -1   -1   -1   -1  838 
  -1  294   15   16   16   16   16   17   -1   -1  253  893  455   -1   -1   -1   -1   -1   -1   -1   -1   -1   -1  215  215  215  215  215   -1   -1   -1   -1   -1   -1   -1   -1   -1   -1   -1   -1   -1   -1   -1   -1   -1   -1   -1   -1   -1   -1 
  -1  294   82   83   83   83  351   84   -1  893  455  893  253   -1   -1   -1   -1   -1   -1   -1   -1   -1   -1  216  216  216  216  216   -1   -1   -1   -1   -1   -1   -1   -1   -1   -1   -1   -1   -1   -1   -1   -1   -1   -1   -1   -1   -1   -1 
  -1   -1  149  150  150  150  150  151   -1  893  893   -1   -1   -1   -1   -1   -1   -1   -1   -1   -1   -1   -1   15   16   16   16   17  762  631  631  631  631  631  631  631  631  631  632   -1   -1   -1   -1   -1   -1   -1   -1   -1   -1   -1 
  -1   -1  774   -1   -1   -1  548  293   -1  455  893   -1   -1   -1   -1   -1   -1   -1   -1   -1   -1   -1  455   82   83  484  485   84   -1   -1   -1  774   -1   -1   -1   -1   -1   -1  699   -1   -1   -1   -1   -1   -1   -1   -1   -1   -1   -1 
  -1   -1   -1   -1   -1   -1   -1   -1   -1  893  455  253   -1   -1   -1   -1   -1   -1   -1   -1   -1   -1  253  149  150  150  150  151   -1   -1   -1   -1   -1   -1   -1   -1   -1   -1  699   -1   -1   -1 1050 1051   -1   -1   -1   -1   -1   -1 
  -1   -1   -1   -1   -1   -1   -1   -1   -1   -1   -1   -1   -1   -1   -1   -1   -1   -1   -1   -1   -1   -1   -1   -1   -1   -1  548  697   -1   -1   -1   -1   -1   -1   -1   -1   -1   -1  699   -1   -1   -1   -1   -1   -1  688   -1  838  905  838 
  -1   -1   -1   -1   -1   -1   -1   -1   -1   -1   -1   -1   -1   -1   -1   -1   -1   -1   -1   -1   -1   -1   -1   -1   -1   -1   -1  697   -1   -1   -1   -1   -1   -1   -1   -1   -1   -1  699   -1   -1   -1   -1   -1   -1   -1  838   -1   -1   -1 
  -1   -1   -1   -1   -1   -1   -1   -1   -1   -1   -1   -1   -1   -1   -1   -1   -1   -1   -1   -1   -1   -1   -1   -1   -1   -1   -1  697   -1   -1   -1   -1   -1   -1   -1   -1   -1   -1  699   -1   -1   -1   -1   -1   -1   -1  838   -1   -1   -1 
  -1   -1   -1   -1   -1   -1   -1   -1   -1   -1   -1   -1   -1  215  215  215  215  215  215  215   -1   -1   -1   -1   -1   -1   -1  764  631  631  631  631  631  631  631  631  631  631  766   -1   -1   -1   -1   -1   -1   -1   -1   -1   -1   -1 
  -1   -1   -1   -1   -1   -1   -1   -1   -1   -1   -1   -1   -1  216  216  216  216  216  216  216   -1   -1   -1   -1   -1   -1   -1   -1   -1   -1   -1   -1   -1   -1   -1   -1   -1   -1   -1   -1   -1   -1   -1   -1   -1   -1   -1   -1   -1   -1 
  -1   -1   -1   -1   -1   -1   -1   -1   -1   -1   -1   -1   -1   12   13   13   13   13   13   14   -1   -1   -1   -1   -1   -1   -1   -1   -1   -1   -1   -1   -1   -1   -1   -1   -1   -1  214  214  214  214  214  214  214  214   -1   -1   -1   -1 
  -1   -1   -1   -1   -1   -1   -1   -1   -1   -1   -1   -1   -1   79   80   80   80  690  691   81   -1   -1   -1   -1   -1   -1   -1   -1   -1   -1   -1   -1   -1   -1   -1   -1   -1   -1  214  214  214  214  214  214  214  214   -1   -1   -1   -1 
  -1   -1   -1   -1   -1   -1   -1   -1   -1   -1   -1   -1   -1  146  147  147  147  757  758  148   -1   -1   -1   -1   -1   -1   -1   -1   -1   -1   -1   -1  729   -1   -1   -1   -1   -1   15   16   16   16   16   16   16   17   -1   -1   -1   -1 
  -1   -1   -1   -1   -1   -1   -1   -1   -1   -1   -1   -1   -1   -1  387   -1   -1   -1   -1  387   -1   -1   -1   -1   -1   -1   -1   -1   -1   -1   -1   -1   -1   -1   -1   -1   -1   -1   82  352   83   83   83   83  352   84  184   -1   -1   -1 
  -1   -1   -1   -1   -1  729   -1   -1   -1   -1   -1   -1   -1   -1   -1   -1   -1   -1   -1   -1   -1   -1   -1   -1   -1   -1   -1   -1   -1   -1   -1   -1   -1  710  711   -1   -1   -1  149  150  150  150  150  150  150  151  251   -1   -1   -1 
  -1   -1   -1   -1   -1   -1   -1   -1   -1   -1   -1   -1   -1   35   -1   -1   -1   -1   -1   -1   -1   -1  893   -1   -1   -1   -1   -1   -1   -1   -1   -1   -1  777  778   -1   -1   -1  387   -1   -1   -1   -1   -1   -1   51   -1   -1   -1   -1 
  -1   -1  729   -1   -1   -1   -1   -1   -1   -1   -1   -1   -1   -1   -1   -1   -1   -1   -1   -1   -1   -1   -1   -1   -1   -1   -1   -1   -1   -1   -1   -1   -1   -1   -1   -1   -1   -1   -1   -1   -1   -1   -1   -1   -1  118   -1   -1   -1   -1 
  -1   -1   -1   -1   -1   -1   -1   -1   -1   -1   -1   -1   -1   -1   -1   -1   -1   -1   -1   -1   -1   -1   -1   -1   -1   -1   -1   -1   -1   -1   -1   -1   -1   -1   -1   -1   -1   -1   -1   35   -1   -1   -1   -1   -1   -1   -1   -1   -1   -1 
  -1   -1   -1   -1   -1   -1   -1   -1   -1   -1   -1   -1   -1   -1   -1   -1   -1   -1   -1   -1   -1   -1   -1   -1   -1   -1   -1   -1   -1   -1   -1   -1   -1   -1   -1   -1   -1   -1   -1   -1   -1   -1   -1   -1   -1  729   -1   -1   -1   -1 
  -1  487  488  489   -1   -1   -1   -1   -1   -1   -1   -1   -1   -1   -1   -1   -1  838 1029 1030  698   -1   -1   -1   -1   -1   -1   -1   -1   -1   -1   -1   -1   -1   -1   -1   -1   -1   -1   -1   -1   -1   -1   -1   -1   -1   -1   -1   -1   -1 
  -1   -1   -1   -1   -1   -1   -1   -1  436  437   -1  729   -1   -1   -1   -1   -1   -1   -1   -1  765   -1   -1   -1   -1   -1   -1   -1   -1   -1   -1   -1   -1   -1   -1   -1   -1   -1   -1   -1   -1   -1   -1   -1   -1   -1   -1   -1   -1   -1 
  -1   -1   -1   -1   -1   -1   -1   -1  503  504   -1   -1   -1   -1   -1   -1   -1   -1   -1   -1   -1   -1   -1   -1   -1   -1   -1   -1   -1   -1   -1   -1  729   -1   -1   -1   -1   -1   -1   -1   -1   -1   -1   -1   -1   -1   -1   -1   -1   -1 
  -1   -1   -1   -1   -1   -1   -1   -1   -1   -1   -1   -1   -1   -1   -1   -1   -1  688   -1   -1   -1   -1   -1   -1   -1   -1   -1   -1   -1   -1   -1   -1   -1   -1   -1   -1   -1   -1   -1   -1   -1   -1   -1   -1   -1   -1   -1   -1   -1   -1 
  -1   -1   -1   -1   -1   -1  688   -1   -1   -1   -1   -1   -1   -1   -1   -1   -1   -1  688   -1  688   -1   -1   -1   -1   -1   -1   -1   -1   -1   -1   -1   -1   -1   -1   -1   -1   -1  554   -1   -1   -1   -1   -1   -1   -1   -1   -1   -1   -1 